的	dkrrrr
一	jeeeee
了	cuiiii
是	siueee
不	heoirr
我	woeieu
他	jduiuu
在	dleiee
人	dorrrr
有	dhiuee
这	nrrurr
来	wniorr
你	jaouio
个	djiiii
上	lieeee
到	gniiii
大	keorrr
道	ajrurr
着	kbiuee
说	skouuu
她	mduiuu
们	jfriuu
也	duiuuu
就	lxrrrr
那	syuiii
地	lduiuu
中	viueii
子	suieee
出	ysuiii
要	tmuoee
下	leirrr
为	jwrrrr
得	fqeirr
和	ckiuee
么	jcurrr
时	wjeirr
可	geiuei
去	weieur
会	dmeeur
里	giueei
过	jrrurr
以	burorr
看	nbiuee
然	bprrrr
对	fjeirr
自	joiuee
好	msuiee
天	feeorr
之	krurrr
没	ndouur
都	fyuiii
小	ciorrr
心	lrurrr
能	chouou
还	hrrurr
而	yeoiui
后	aleiue
想	vlrurr
起	mgueuu
生	goeeie
家	vheouo
只	kforrr
多	bbourr
手	noeeii
事	lsueei
面	heoiui
国	ksrrrr
头	wkeorr
发	xuourr
如	mkiuee
无	jxeouu
身	zoiuee
用	toueei
又	furrrr
把	gguieu
样	tkroee
开	neeoii
于	aeeiii
点	tnrrrr
前	aroeiu
已	gueuuu
知	vkiuee
什	jpeiii
所	avooei
方	mreuoo
现	sfouuu
经	xpurei
见	fiuouu
成	ktuuuu
些	tyeeee
法	nweieu
行	faeeii
声	lzuieo
年	vjeiei
意	mlrurr
己	gueuuu
当	ccueee
但	jqiuee
笑	lfoeor
老	fnouuu
两	fforor
很	fhueeu
情	hheeie
从	fororr
作	jzoeie
动	mwuooo
话	snoeii
回	xiuiue
力	wuoooo
儿	xouuuu
三	peeeee
长	boeurr
走	meieie
明	whouee
间	fwiuee
同	sleiue
分	soruoo
气	voeeuu
十	peiiii
眼	bhueeu
女	muoeee
将	zbeirr
定	prruei
种	cviuei
进	yrrurr
本	tjeeee
此	tieieo
向	zkiuee
正	keieie
真	hforrr
实	vweorr
给	xcorei
高	gkiuee
被	hzuoiu
学	nsuiee
问	fkiuee
神	hwiiii
与	qjeeee
再	fleiee
才	teiooo
全	dseeie
太	kjrrrr
因	qiueor
其	geiiee
主	kreeie
日	wiueee
打	gaeiii
却	wwuiii
让	slieee
文	nreorr
最	wyurrr
口	kiueee
听	kqooei
外	blirrr
二	yeeeee
门	friuuu
几	aouuuu
理	sgiuee
公	corurr
等	lleirr
相	veiori
光	hiroeo
西	teiuou
白	doiuee
先	goeieo
者	feieoi
便	jbeiue
住	jkreei
使	jlorrr
并	aneoii
重	ngiuee
信	jsreee
斯	gqooei
感	klrurr
做	jvoeor
水	niuorr
新	htooei
风	ahorrr
应	amrroe
少	vioroo
边	wrrurr
觉	nfiuou
色	dguieu
别	kwiiii
名	bkiuee
特	cleirr
何	jgeiue
次	preouo
山	yiuiii
机	taouuu
吧	kguieu
位	jhrero
比	meuouu
关	akeorr
体	jteeee
部	hkuiii
第	lxiooo
果	wteior
马	auueee
死	bnouuu
处	nlirrr
怎	zlrurr
安	vmuoee
东	yciorr
像	jwouiu
四	ciuoue
工	leieee
王	seeiee
更	beiuee
月	houeee
由	aiueie
金	voreei
呢	kzouuu
尔	aouior
直	heiiue
数	qmoeor
内	liuorr
它	vnouuu
路	zzouri
快	hvorrr
美	kkeorr
叫	kbuiii
吗	kauuee
军	qyeuei
接	ghuoee
加	tuoiue
平	heroei
张	xboeur
望	xheeie
常	cyiuii
放	mnoeor
表	xjouor
难	fmoire
性	hgoeei
入	dorrrr
场	ltoooo
算	lbeoii
海	nvuure
脸	hqrroe
花	fyoiou
龙	leouor
连	yrrurr
战	tkeuor
轻	ypurei
爱	ydurrr
夫	jeeorr
利	cniiii
带	fqiuii
亲	hteior
合	coreiu
通	trrurr
清	nheeie
立	hreroe
候	jvoeeo
目	biueee
民	queueu
系	jduuri
拉	ghrero
变	pfurrr
五	jeiuee
原	adiorr
完	vleeou
结	xneiei
化	yoiouu
跟	zhueeu
世	dpuuuu
空	dleiee
受	yfurrr
车	yeueii
教	fsoeor
今	qorruu
业	jiiroe
啊	kyeiue
许	sveiii
强	xkiuei
飞	pworrr
德	fpiuii
解	hsoeei
电	wpuuuu
量	qgiuee
思	glrurr
总	klrurr
任	jsoeie
物	cjouoo
度	dfurrr
活	nnoeii
件	jcoeei
林	meiore
师	njiuii
非	zieeei
克	vxouuu
象	wouiue
万	weuooo
该	shreuo
命	qkuiii
士	leieee
似	jburor
城	lkuuuu
至	geurei
吃	kvuuuu
提	gsiuee
转	yyurrr
制	vyiiii
市	byiuii
黑	xiuroe
火	proorr
云	meeurr
报	gwurrr
指	gniuee
书	ttirrr
远	lrrurr
找	gkeuor
满	nfeiuo
记	sgueuu
管	lviueu
干	neeiii
计	speiii
且	biueee
红	xleiee
房	tmreuo
步	hciooo
必	ljoooo
微	aaouuu
南	psroee
字	vsuiee
反	afurrr
华	ypeiii
百	jdoiue
言	sreeei
李	tsuiee
认	sdorrr
往	fkreei
形	nwoooo
服	hwurrr
倒	jgiiii
离	qliuur
刚	shiiii
虽	kbiuei
罗	cbourr
双	fururr
告	joeiei
站	htieiu
乎	boroei
流	nxoiuu
或	kkeeee
坐	fleiee
深	nqorei
冷	wqorru
各	zouriu
传	jyurrr
音	mreroe
息	jlrurr
石	deoiue
及	sourrr
保	jsiuee
语	sjiuee
剑	qmiiii
交	qhorrr
若	fdiuee
容	ddiuee
怕	hdoiue
条	nteior
界	gdoiii
半	jroeei
达	krrurr
奇	kgeiue
青	heeiei
题	sneoiu
早	wpeiii
元	leeouu
建	srurrr
失	jjeeor
近	qrrurr
惊	hlreiu
则	dniiii
魔	ysoiue
即	twuiii
队	ydorrr
程	ckeeie
切	nsuooo
衣	jreouo
谁	smoire
北	zieeou
落	yzouri
杀	hteior
式	kleiee
精	qheeie
酒	nteiuo
产	haeooo
请	sheeie
论	saorou
统	xxouuu
决	wvorrr
星	wgoeei
义	nrorrr
刻	hniiii
极	tsourr
未	deeior
求	weireo
随	ydiuee
竟	mxouuu
格	tzouri
影	wloooo
每	vvuure
区	meoruu
兴	mforrr
紧	mduuri
兵	qforrr
办	wforrr
展	zpuorr
始	mciuee
八	forrrr
功	lwuooo
武	jkieie
政	knoeor
喜	akiuee
拿	cnoeei
孩	shreuo
男	gwuooo
员	kdiuor
灵	cproor
阿	ygeiue
务	nwuooo
江	nleiee
钱	vkeeuo
根	thueeu
图	knrrrr
布	dyiuii
您	jarurr
令	qorrur
突	dpeorr
设	sdouur
据	gzeiiu
绝	xduieu
收	bnoeor
越	mkeuuo
整	zneiei
基	gleiee
院	yveeou
姐	mbiuee
父	lororr
怪	hfeiee
期	ghouee
术	tjrrrr
暗	wmrero
九	gouuuu
店	atieiu
乐	pciorr
识	skorrr
友	dfurrr
般	pdouur
片	koieuu
七	neuuuu
尽	kwrrrr
哪	ksuiii
集	mteior
阳	ywiuee
客	vzouri
伤	jvuooo
答	lcorei
夜	bjourr
领	qneoiu
千	noeiii
周	sneiei
装	zlreou
写	qqeeee
苦	fveiiu
血	jciuii
视	hfiuou
击	lsuiii
取	yfurrr
消	nciuee
司	tleiue
弟	xroueu
哥	ggeiue
玉	sjrrrr
静	hbouue
阵	yyeuei
单	hroiue
亚	seiiro
代	boieur
运	mrrurr
六	qreorr
众	dforor
品	khiuei
足	kmieor
族	dvoeeo
科	cweiii
类	qkeorr
雷	pgiuei
断	qpooei
社	hleiee
留	pgiuei
晚	wwouuu
兰	ayeeee
谈	sproor
器	hpiuei
准	wmoire
够	kkouro
确	dhouou
易	wjouoo
黄	paorrr
复	vwourr
送	akrurr
团	kteioo
句	kkiuee
官	vhiueu
敢	tyoeor
修	jnoooo
照	wsiuer
丽	ceiuri
备	ngiuei
急	xlrurr
忙	hxreuu
母	vuurer
欢	faouor
英	fseorr
古	veiiue
底	amrrrr
巴	guieuu
帮	xyiuii
终	xnrrrr
势	dwuooo
娘	mjueeu
热	dnrrrr
显	wjiiro
朝	xhouee
错	vpiuee
持	gleirr
调	sseiei
宝	vsrrrr
香	cwiuee
低	jmrrrr
丝	ppeeee
曾	wroiui
冲	wviuei
线	xkeeuo
级	xsourr
示	seeior
改	gnoeor
待	fleirr
包	kgueuu
台	ckiuee
沉	nqouuu
愿	adiorr
久	tourrr
希	hdiuii
木	teiorr
响	kziuee
破	dzuoiu
首	ajoiue
模	tyeiii
脚	hwuiii
害	vxiuee
约	xkrrrr
资	pdiuor
穿	daeuio
联	yaeorr
哈	kcorei
树	tfeirr
雪	pcueee
楚	mmuieo
注	nkreei
引	xjiiii
护	gtrueo
另	kwuooo
故	vnoeor
村	tjeirr
存	dsuiee
嘴	ktouou
依	jjreou
诉	sqrrrr
造	jrrurr
技	gpurrr
露	pzouri
除	yqeior
慢	hwiuii
具	bforrr
摇	gyoeei
观	ffiuou
楼	tquoee
商	hsoriu
型	nneiee
府	ajeirr
停	jgeiii
爷	lwuiii
铁	vjeeor
段	goieee
广	areooo
念	qlrurr
组	xbiuee
节	fwuiii
需	pyeoiu
议	snrorr
举	mfeeii
支	pfurrr
细	xgiuei
跑	zkueuu
维	xmoire
异	gneoii
陈	yyiorr
乱	npuuuu
况	wkouuu
忽	jlrurr
妈	mauuee
刀	suoooo
痛	lturiu
群	ckroee
居	zveiiu
速	zrrurr
兄	kxouuu
睛	bheeie
究	dgouuu
斗	wpeiii
卡	llirrr
甚	gpuuuu
帝	hyiuii
喝	kwouor
态	kjrurr
怀	hheoir
局	ztiuee
派	naouor
杨	ttoooo
谢	szeirr
脑	hqreor
病	lforor
顿	bneoiu
治	nciuee
福	hliuei
角	hououe
旁	hmreuo
威	kjuoee
叶	kpeiii
京	lreiue
围	kjeeui
园	kleeou
皮	zuoiur
雨	peiuir
号	kweuuu
密	vloiui
须	wneoiu
推	gmoire
背	zhiuee
河	ngeiue
亮	gaouuu
姑	mveiiu
证	skeiei
费	xniuor
汉	nfurrr
志	llrurr
查	tqiuee
圣	fleiee
呼	kboroe
讲	syeeoi
续	xpurre
标	tseeio
共	peiieo
尼	znouuu
米	qroeio
际	yseeio
招	gsiuee
超	msiuee
差	kleiee
仍	jwuooo
块	lvorrr
莫	yeiiiu
游	nduiee
药	fxourr
船	paiuee
网	shorrr
掌	cnoeei
呀	kaeuio
掉	gliuee
皇	dseeie
玩	sleeou
梦	mbourr
选	grrurr
争	bouuee
疑	nvurui
既	tneuou
波	nzuoiu
闪	fdorrr
室	vgeure
料	qweiii
简	lfiuee
佛	jxoiii
堂	cleiee
索	bduuri
规	jfiuou
朋	hhouee
攻	lnoeor
章	mpeiii
礼	hpuuuu
鬼	soiuee
春	lwiuee
刘	nniiii
严	sjoooo
赶	mneeii
睡	bzoeie
屋	zgeure
食	porrue
饭	paurrr
济	nnoiii
试	skeiee
仙	jyiuii
导	gjeirr
参	cwoooo
沙	nvioro
永	jtuorr
肯	hhiuee
环	sheoir
农	lruouo
恶	slrurr
称	caouio
止	hieiee
初	hsuooo
医	vvoeeo
敌	nnoeor
跳	zxreor
假	jqueie
左	dleiee
散	phoeor
温	nwiuii
继	xquuuu
换	gdiueo
权	tfurrr
银	vhueeu
君	ckiuee
退	hrrurr
闻	fyeiie
激	ndreuo
画	jguiii
较	yqorrr
烈	bnrrrr
独	pbiuei
球	sweire
土	leieee
层	zmeeur
卫	wjeeee
抱	gkueuu
草	fweiii
专	ytrrrr
烟	pqiueo
余	qteior
秋	cproor
顺	wneoiu
顾	ageoiu
否	hkiuee
值	jheiiu
考	fqeuee
冰	wniuor
境	lmouuu
妹	mdeeio
恐	larrur
怒	clrurr
伯	jdoiue
质	apiuor
艺	fpuuuu
味	kdeeio
历	awuooo
构	tkurrr
研	dneeoi
施	dduiuu
贵	ldiuor
委	cmuoee
渐	nyooei
淡	nproor
史	khorrr
校	tqorrr
狂	pseeie
馆	pviueu
板	taurrr
排	gzieee
价	jdoiii
街	fheeii
宫	vkiuee
追	jhrurr
靠	jzieee
忍	sjrurr
普	ajiuee
致	gnoeor
钟	vviuei
娜	msuiii
耳	yeiiee
属	zjiuei
忘	xlrurr
苏	fwrrrr
伙	jproor
仅	jfurrr
景	wlreiu
松	tcorur
州	wnrrrr
胡	vhouee
纪	xgueuu
印	pjuiii
赵	mhorrr
置	cheiiu
投	gdouur
列	bniiii
隐	yxrurr
缓	xyeeou
座	afeiee
庄	aleiee
幸	lkroee
副	lgiiii
充	xxouuu
守	vjeirr
胜	hgoeei
救	wnoeor
射	zjeirr
齐	nnoiii
顶	aneoiu
助	bwuooo
右	dkiuee
素	xduuri
唐	asiuee
抓	gyooir
巨	vvueee
毛	woeeuu
诗	sleirr
弄	sneoii
防	ymreuo
雅	amoire
源	naoiue
户	trueoo
湖	nvouee
项	lneoiu
党	cxouuu
压	alrrrr
寒	hwrrrr
效	qhoeor
奥	zqeorr
毫	gwoeeu
增	lwroiu
险	yqrroe
状	zpeorr
按	gvuoee
买	tweorr
禁	mseeio
阴	yhouee
叹	kfurrr
蓝	fliuii
察	vyeeio
承	cpuorr
省	vbiuee
份	jsoruo
托	gjeuuu
恩	qlrurr
责	xdiuor
挥	gqeuei
洛	nzouri
妇	mcueee
牛	coeeii
习	yureee
警	dkoeor
默	xpeorr
岁	ybourr
骑	akeiue
股	hdouur
划	kniiii
负	ddiuor
枪	tduuuu
梅	tvuure
采	yteior
吸	ksourr
富	vliuei
舞	vfoure
肉	ldorrr
镇	vhorrr
野	ghurui
床	ateior
某	dteior
醒	twoeei
验	aqrroe
读	spurre
担	gqiuee
毒	xvuure
封	hjeirr
尚	csiuee
纳	xliuor
伊	jcueeo
营	wkiuee
猛	psiuii
短	vheiue
旧	jwiuee
脱	hkouuu
遇	wlrurr
词	steiue
坏	lheoir
控	gdeiee
田	giueie
乡	pjoooo
刺	qniiii
啦	kgrero
孙	sciorr
翻	mgureu
藏	fkueoe
虎	daouuu
坚	mleiee
良	jhueeu
柔	hteior
眉	zbiuee
伸	jwiiii
窗	dzoure
咱	kjoiue
婚	mmiuee
戏	fkeuor
逃	xnrurr
赛	hdiuor
扬	gtoooo
凡	ajrrrr
凌	wlorou
配	tgueuu
练	xyuorr
率	bpreor
贝	diuorr
宇	vaeeii
茶	fdeior
优	jxrrrr
杰	tnrrrr
吉	neieiu
卷	lguuuu
创	dgiiii
罢	cweieu
秀	cwuooo
归	ncueee
哭	hpeorr
凤	afurrr
陆	yluiii
端	hyeoiu
休	jteior
库	ayeuei
序	ahurui
善	kaiuee
秘	cloooo
拍	gdoiue
案	vmeior
迷	qrrurr
震	pyeoee
免	wxouuu
职	ykorrr
洋	nkroee
寻	cjeirr
养	kjoiii
珠	sjeeio
歌	ggouor
盘	pciuii
朱	jdeeio
演	nveiue
虚	djiiro
呆	siueei
付	jjeirr
笔	lwoeeu
适	nrrurr
康	acireo
麻	yreoei
宁	vaeiii
吴	kfeeor
欲	fdiueo
罪	czieee
恨	hhueeu
杂	gteior
套	kbeiee
骨	miuuru
紫	tduuri
软	yaouor
蒙	wjeouo
弹	xhroiu
育	xhiuee
企	dhieie
仿	jmreuo
泪	nbiuee
曲	aiueii
鱼	douiue
兽	wgeiue
略	gzouri
握	gzeure
厅	aaeiii
厉	aweuoo
卖	ptrreo
供	jpeiie
丹	sbreee
喊	kkeiue
峰	yneeei
灯	paeiii
绿	xcireo
夏	dbourr
塔	lforei
桌	lweior
范	yguuuu
限	yhueeu
县	bcurrr
讨	sjeirr
革	qeiiei
燕	dkieeo
欧	maouor
临	nvriui
移	cbourr
洞	nseiue
剧	zviiii
油	naiuei
束	zeiuei
替	jjiuee
概	tteuou
秦	lcoeio
协	pwrrrr
材	tteioo
魂	msoiue
织	xkorrr
智	vkiuee
诺	sfeoiu
爵	ycueeu
丁	aeiiii
劳	wwuooo
律	fsueee
瞧	bmrrrr
丈	djrrrr
尊	djeirr
摆	gceieu
彩	ytoooo
输	yqiuee
败	dnoeor
抬	gciuee
徐	fqeior
熟	gsourr
森	tmeior
探	gqorei
毕	mpeiii
预	hneoiu
雄	dcoire
测	ndiiii
牙	aeuioo
混	nweuou
升	jneoii
甲	aiueei
祖	hbiuee
瑞	syeoiu
例	jbiiii
迎	pwrurr
胸	hkorui
晓	wpeuoe
透	cwrurr
鲁	dwiuee
架	tteior
纸	xmoueu
洗	ngoeie
浪	njueeu
亦	preoio
抗	gbouuu
烦	pneoiu
班	sneeie
盖	kciuii
宗	vseeio
塞	hleiee
登	yheiue
墙	lproei
闲	fteior
烧	ppeuoe
硬	dbeiue
危	hguuuu
肩	thiuee
午	vpeiii
妙	mvioro
偷	jqiuee
互	jauuee
荣	wteior
含	qkiuee
检	tqrroe
执	deieou
菜	fyeior
柳	tpouou
域	lkiuee
伦	jaorou
灭	jproor
席	dyiuii
莱	fwiorr
编	xtiuei
益	afiuii
呵	kgeiue
摸	gyeiii
弱	xwueur
闹	fbiuii
徒	fmeiei
述	tjrurr
货	ydiuor
博	pfeirr
劲	pwuooo
宣	vjiuee
姓	mgoeei
操	gkiuei
获	fpeorr
懂	hfoeiu
萧	fsoior
蒂	fhiuii
著	ffeieo
妻	jsuoee
鲜	dkroee
旅	djouor
敬	dkoeor
趣	myurrr
避	brrurr
亡	xreuuu
释	mfeeii
积	ckorrr
圆	kkiuor
杯	theoir
牌	kdoiue
批	gmeuou
阶	ydoiii
爸	lguieu
占	tieiue
拥	gtouee
辈	zyeuei
困	kteior
腿	hhrurr
杜	tleiee
横	tpiuei
扑	glirrr
抽	gaiuei
羽	yureur
借	jpiuee
妖	mfoeor
征	fkeiei
莉	fciiii
吓	kleirr
策	lqeiui
犯	pguuuu
袋	bjreou
狠	phueeu
骂	hauuee
曼	wcurrr
纷	xsoruo
虑	dlrurr
婆	nzuoee
奶	mwuooo
挂	gheiee
拜	njeeei
码	dauuee
悲	zlrurr
佳	jheiee
财	dteioo
桥	tfoiii
盛	ktiuii
怜	hqorru
奔	kpeoii
玛	sauuee
勒	qwuooo
介	dnoiii
厂	aeoooo
巧	lweuuu
狗	pkiuee
尖	ckeorr
勇	twuooo
泰	lnireo
冒	wbiuee
轮	yaorou
谷	fdiuee
菲	fzieee
孔	spuuuu
庭	asurrr
监	lciuii
伟	jjeeui
健	jsurrr
尤	xjrrrr
暴	wpireo
络	xzouri
丰	xeeeii
餐	lburor
唱	kwiuee
偏	jtiuei
误	skeeor
哼	kguiii
飘	tsouor
岛	fyiuii
凝	wnoeeo
迪	arrurr
萨	fyrero
聚	yfoioo
惜	hpiuee
狼	pjueeu
诚	skuuuu
闭	fteioo
缘	xaouoo
碰	daiiro
迹	prrurr
折	meieoo
篇	ltiuei
庆	akeorr
洲	nwrrrr
凯	ygouuu
残	bkeeuo
稳	cxrurr
鼓	apurrr
腰	htuoee
诸	sfeieo
韩	xjeeui
版	kaurrr
附	yjeirr
叔	lcurrr
沈	nqouuu
瓦	jeuurr
唯	kmoire
降	yneuii
挑	gxreor
镜	vmouuu
访	smreuo
姆	mvuure
舒	qvurui
犹	pxrrrr
补	hlirrr
港	npueuu
幽	ypuurr
豪	gheouo
殿	zpouur
宽	vfiuou
郎	jtuiii
哦	kwoeie
评	sheroe
灰	dproor
缺	yvorrr
玄	bpuurr
厚	awuiee
私	ccurrr
臂	bhiuee
艾	fhorrr
谓	sgiuee
妮	mzouuu
训	swoiii
舍	qveiiu
遍	tlrurr
孤	syoour
颜	haoooe
陪	yhiuee
拳	lnoeei
奋	kgiuei
迟	krrurr
竹	loeioe
仇	jgouuu
稍	cciuee
遗	ldrurr
判	jniiii
戴	qgeiie
讯	speiii
汽	nvoeeu
乔	fnoiii
疯	laorrr
壁	bleiee
献	psroee
芳	fmreuo
番	mgiuei
凭	jsouuu
胆	hqiuee
琴	ssorru
尘	cleiee
挺	gsurrr
弃	xneoii
仁	jyeeee
乌	kteeee
碎	dboror
搞	ggiuee
录	cnireo
赞	ggiuor
迅	pprurr
佩	jaeiui
童	hgiuee
邪	ayuiii
择	gfeeii
嘛	kyreoe
躲	zaeior
朗	jtouee
宋	vteior
逐	hrrurr
忠	vlrurr
吹	kaouor
摩	ynoeei
幻	ptuuuu
朵	ateior
欣	qaouor
抢	gduuuu
埃	lcoeeo
炼	pyuorr
纯	xbeuiu
典	aforrr
躺	zciuiu
泽	nfeeii
针	vpeiii
圈	kluuuu
皱	xzuoiu
糊	qvouee
固	kveiiu
锋	vneeei
乃	wuoooo
均	lkreee
凉	wlreiu
浮	nyuiee
触	hbiuei
唇	ykiuee
页	neoiuo
娇	mfoiii
隔	yleiue
纵	xforor
绍	xsiuee
昨	wzoeie
蛋	mbiuei
侧	jdiiii
悄	hciuee
荡	ytoooo
伴	jjroee
箭	laroei
咬	kqorrr
迫	drrurr
累	gduuri
傲	jkeeie
扎	gpuuuu
载	qyeuie
鸟	fouruu
饰	pviuii
腾	hluuee
撞	ghiuee
惨	hcoooo
猜	pheeie
努	cwuooo
珍	sdoooo
尸	zueooo
滚	nqurou
插	gnoieu
氏	moueuu
吻	kjouoo
扫	gcueee
川	woiiii
丢	jweieu
抵	gmrrrr
减	wkeiue
池	nduiuu
彼	fzuoiu
莲	fyrurr
票	tseeio
伏	jpeorr
粉	qsoruo
昏	mwiuee
刊	nniiii
鼻	jgiuei
阻	ybiuee
臣	qeiuei
梁	nsrrei
奈	kseeio
翼	ygeiie
逼	lgrurr
晶	wwiuee
嘿	kxiuro
粗	qbiuee
忆	hpuuuu
弗	xnoiii
吐	kleiee
盯	baeiii
央	skeorr
曰	wiueee
麦	xnourr
缩	xvoieo
盟	whiuii
瞪	byeiue
距	zvueee
芒	fxreuu
符	ljeirr
堆	lmoire
忧	hxrrrr
鸡	ffouru
幕	yyiuii
爆	pweiie
挡	gcueee
晨	wyeoee
颗	wteoiu
旋	dmuieo
振	gyeoee
净	wbouue
析	tqooei
惯	hviuor
赫	cceieo
辛	nreroe
钢	vsorrr
敏	vvoeor
苍	fduuuu
描	gfiuei
赏	cdiuor
款	lsouor
凶	hsuiii
颤	bxiuee
洁	nneiei
陷	ydoieu
损	gkiuor
汗	nneeii
谋	sdeior
径	fpurei
夺	kjeirr
鞋	qheiee
延	jhurrr
莎	yvioro
漂	nteeio
抖	gweiii
遭	jaiuee
瞬	byoure
坦	lqiuee
愈	qhiiru
椅	tkeiue
岸	yaeeii
裂	bnreou
洪	npeiie
途	qtrurr
剩	cziiii
额	vzeoiu
销	vciuee
磨	ydeoiu
贴	dtieiu
季	csuiee
享	gsuiee
赤	ceieoi
吟	kqorru
愤	hpeiii
醉	tboror
枝	tpurrr
慕	ycirrr
壮	zleiee
隆	yneoee
仔	jsuiee
恢	hdroor
乘	czieeo
穷	dwuooo
映	wseorr
皆	mdoiue
扶	gjeeor
阁	fzouri
俊	jcorou
漫	nwiuii
祥	hkroee
桑	ffeior
岂	ygueuu
堡	jseiee
惑	kkerur
貌	ddouuu
袭	ljreou
仰	jpuiii
嘉	atuoiu
鸣	kfouru
邦	xyuiii
岳	qyiuii
琳	smeior
滑	nmiuur
跃	zfoeor
宜	vbiuee
俩	jforor
毁	tlouur
汇	nveuuu
绕	xpeuoe
慧	xxueer
逸	wxrrur
怨	bgrurr
御	fvieie
唤	kdiueo
闷	flrurr
荒	fxoiuu
爬	yguieu
厌	apeorr
傻	jzoreo
薄	yfeirr
旗	dgeiie
涌	nturiu
雾	pnuooo
羊	kroeee
吕	kkiuee
仪	jnrorr
匆	jjrrrr
泉	dniuor
拖	gvuiuu
零	pqorru
孟	sciuii
贼	dkeooo
骗	atiuei
辉	hqeuei
尾	zwoeeu
恋	plrurr
融	lbiuei
锁	vciuor
耐	yjeirr
核	threuo
铺	vfeiue
炸	pzoeie
末	deeior
拼	gaeoii
慌	hfreuo
枫	taorrr
启	tkiuee
冬	nwrrrr
潮	nxouee
甘	deiiee
帐	yboeur
暂	yqiuee
睁	bbouue
翠	yboror
汤	ntoooo
郑	akuiii
寂	vlioru
掩	gkiuee
宾	vqorrr
译	sfeeii
促	jkieor
递	xrrurr
踪	zveeio
炮	pkueuu
扩	gareoo
旦	qiueee
倾	jneoiu
垂	zoeiei
侯	jvoeeo
郭	gsuiii
括	gnoeii
审	vwiiii
督	lcuriu
浓	nlruou
匹	vxouuu
胖	hjroee
培	lhiuee
潜	njeeor
嗯	kqrurr
宏	vdurrr
戒	kneoii
尺	kueorr
彻	fnuooo
蛇	bvouuu
擦	gvourr
晃	whiroe
侍	jleirr
羞	kauiee
拔	gdurrr
慰	zseirr
课	sweior
聊	ypouou
爹	lbourr
亿	jpuuuu
疾	lvoeeo
航	pbouuu
浑	nqeuei
绪	xfeieo
惠	jwierr
舰	pfiuou
泥	nzouuu
狱	pseorr
沿	naiuee
斜	qtrrei
贸	pdiuor
箱	lveior
奉	lleeii
轰	yfurur
俗	jforiu
辞	nnrero
劝	fwuooo
拒	gvueee
鸿	nlouru
墨	xleiee
伍	jjeiue
弯	pxueuu
贫	sdiuor
键	vsurrr
盗	pciuii
湾	npueuu
浩	njoeie
吼	ksuuuu
颇	zneoiu
奴	cuoeur
祝	hkouuu
牧	cnoeor
授	gyurrr
愁	cprurr
霍	pmoire
俄	jwoeie
侠	jworrr
帕	ydoiue
哀	gjouor
抚	gjeouu
奖	zbeorr
疼	lnrrrr
耶	yyuiii
惧	hborrr
姊	mxouio
召	skiuee
饮	paouor
悉	mlrurr
染	ngeior
卢	lzueoo
偶	jwiuie
废	axuour
酸	tcorou
津	nsueee
扭	gauiee
辆	yforor
悠	jnrurr
碧	sdeoiu
脉	hjuuor
踏	zniuee
撒	gpiuee
傅	jfeirr
黎	ckoori
井	yeeoii
挤	gnoiii
询	skiuee
愣	hcreuo
讶	saeuio
暖	wyeeou
聪	ykrurr
夹	wdorrr
赖	zdiuor
筑	llourr
炎	pproor
予	huruii
恼	hqreor
鹰	ajoire
埋	lgiuee
嫁	mveouo
猫	pfiuei
仆	jlirrr
帽	ywiuee
廷	srurrr
焦	mnrrrr
扯	ghieie
敲	gkieur
幅	yliuei
虫	biueie
瓶	aneuur
础	dyuiii
冥	qwreor
仲	jviuei
焰	pdoieu
倍	jhiuee
岩	ydeoiu
董	fniuee
吞	fkiuee
痕	lhueeu
丧	pauorr
曹	jaiuee
牢	vcoeei
甜	ndeiie
钻	vtieiu
悔	hvuure
昌	wwiuee
肚	hleiee
恰	hcorei
庞	aleouo
粮	qjueeu
屈	zyuiii
熊	chouou
缠	xaiuee
赌	dfeieo
韦	jeeuii
霞	pqueie
璃	sqiuur
膀	hhreuo
耀	hyoire
喷	kpeiii
挣	gbouue
寄	vkeiue
溜	npiuei
亭	gaeiii
泛	njrurr
罩	cliuee
冠	qleirr
遥	yyrurr
尝	cqeeur
荷	pgeiue
瘦	ltiurr
唉	kcoeeo
劫	wwuooo
拾	gcorei
欺	gaouor
恭	pcirrr
估	jveiiu
梯	txroue
锦	vdiuii
艳	xduieu
搭	gforei
辑	ykeiie
肃	snorrr
帅	nyiuii
烂	paeeee
锅	vkiuor
俱	jborrr
浴	nforiu
桃	txreor
措	gpiuee
昂	wpuiii
搜	gtiurr
姿	pmuoee
轩	yneeii
穴	drruor
殊	bjeeio
郁	dhuiii
铜	vseiue
疗	lcuiii
陵	ylorou
亏	ytuuuu
扰	gxrrrr
娃	mheiee
竞	hkouuu
截	qmoire
牵	kqoeei
堪	lguuuu
锐	vkouuu
惹	fdiuer
悦	hkouuu
渡	ndurrr
衫	hwoooo
坡	lzuoiu
频	hceoiu
税	ckouuu
抹	gdeeio
袍	hkueuu
宿	vjeoiu
滴	nhiuei
霸	pqouee
鹏	hhouru
忌	glrurr
喃	kpiuro
袖	haiuei
悟	hjiuee
柱	tkreei
陶	ykoeei
申	wjiiii
漠	nyeiii
纹	xnreor
涂	nqeior
迈	wrrurr
跪	zhuuuu
繁	vvoeor
燃	pbeorr
寺	ljeirr
驾	tauuee
搬	gpouur
勃	bsuooo
吾	jkiuee
肥	hguieu
贤	mdiuor
怔	hkeiei
允	cxouuu
链	vyrurr
详	skroee
障	ymeiii
湿	nwiiro
寿	xjeirr
播	gmiuei
缝	xneeei
辰	yeoeeu
舌	noeiiu
喂	kgeuor
瑟	ssruro
猎	ppiuee
啸	ksoior
扇	tyureu
储	jseieo
润	nfeeie
丛	fjeeee
函	cnuiii
灾	vproor
慈	apuurr
购	dkurrr
戈	keuorr
痴	lviuee
返	afrurr
浅	nkeeuo
晴	wheeie
卧	qlirrr
勾	kcurrr
玻	szuoiu
卓	lweiii
扔	gwuooo
炉	ptrueo
脆	hhuuuu
矮	vcuoee
喘	kyeoiu
姜	kmuoee
捉	gkieor
抛	gguooo
葛	fwouor
扣	gkiuee
盾	apiuee
勤	ywuooo
霜	pveior
玲	sqorru
恒	hjiuee
厨	aheirr
冯	wauuee
躯	zmeoru
乖	nzieeo
刑	nniiii
芬	fsoruo
侵	jcruur
薇	faouuu
扮	gsoruo
狐	pyoour
丫	wjiiii
幼	pwuooo
耸	fyeiie
捕	gfeiue
脏	haeiee
沟	nkurrr
丑	auieee
签	lqrroe
仗	jdrrrr
茫	yxreuu
辱	yjeirr
邓	fyuiii
齿	hieieo
嘻	kaiuee
崇	yveeio
翔	kyureu
斩	yqooei
猪	pfeieo
笼	lleouo
糟	qjiuei
贯	vdiuor
液	nboiou
盈	wfiuii
肤	hjeeor
媚	mziuee
拦	gaeeee
屏	zaeoii
咒	haouuu
拟	gburor
涉	nhiooo
嫂	mtiurr
援	gyeeou
违	jrrurr
柏	tdoiue
趁	mdoooo
僧	jwroiu
衡	fdiuei
阔	fnoeii
摄	gyurur
瓜	yoourr
赢	ydiuor
矿	dareoo
裁	qjreou
刹	htiiii
疲	lzuoiu
柯	tgeiue
豫	hwouiu
晕	wqeuei
溪	nyuure
币	jyiuii
淑	nlioru
贺	tdiuor
弓	xueuuu
勉	wxuooo
桂	theiee
懒	hzouiu
雕	snoire
巡	wrrurr
庙	aaiuei
碗	dvouru
铃	vqorru
裤	haeuei
挨	gcoeeo
掠	glreiu
豆	heiuer
寸	jeirrr
誉	mfreee
串	kviuei
割	vxiuei
腹	hviuee
驱	ameoru
奏	lfeeor
甫	feiuee
植	theiiu
诱	scuooo
订	saeiii
蕾	fpiuei
罚	csiiii
披	gzuoiu
覆	tfoeiu
悬	bcrurr
涛	nxeirr
眨	bjrurr
柜	tvueee
矩	vvueee
欠	aouorr
怖	hdiuii
棋	tgeiie
贾	tdiuor
穆	cdioro
姬	mqeiiu
柄	tforrr
饿	pwoeie
琪	sgeiie
邻	qyuiii
姨	mkueuu
驻	akreei
愧	hsoiue
爽	khoror
跌	zjeeor
弥	xaouio
污	nyuuuu
崔	ymoire
臭	jpeorr
苑	fbuuuu
捷	gjueei
摘	ghiuei
吵	kvioro
辩	nsrero
魏	cmoiue
咐	kjeirr
慎	hhorrr
昆	wmeuou
誓	msreee
凑	wleeor
袁	njouor
撤	gxiuee
劈	bsuooo
蛮	pbiuei
卿	pjueeu
歇	wkoruo
添	nfirrr
牲	cgoeei
售	mkiuee
祭	yseeio
纤	xnoeii
咖	ktuoiu
脖	hbuiee
沃	nfoeor
廊	ajueeu
租	cbiuee
撑	gcoeei
岗	ysorrr
嚷	kbiuei
肖	chiuee
旺	wseeie
坊	lmreuo
哎	kforrr
拨	gxuour
酷	tjoeie
乏	jkrurr
稀	cheoiu
烤	pfeuuu
佣	jtouee
踢	zwouoo
碍	dqeirr
宅	vjeuuu
祸	hkiuor
啡	kzieee
跨	zkeeuu
坛	lmeeur
凄	wjueei
综	xveeio
眸	bcoeei
谅	slreiu
虹	bleiee
渊	nnroei
愉	hqiuee
刃	sjrrrr
械	tkeoii
催	jyoire
鞭	qjeiue
邀	dmoeor
届	zaiuei
肠	htoooo
兼	yroeue
洒	nteiuo
娶	yfuoee
绳	xkiuee
鼠	toieue
墓	yleiee
巾	yiuiii
哲	mkiuee
耗	dwoeeu
赐	dwouoo
胁	hwrrrr
婉	mvouru
遮	dnrurr
窝	dkiuor
夸	kyuuuu
逢	nxrurr
泄	nduuuu
砍	daouor
摔	gbuurr
蝶	bdueio
矛	huruio
龄	hqorru
屁	zmeuou
岭	yqorru
韵	mkreee
夕	bourrr
媒	mdeior
卑	doiuee
愚	wlrurr
湘	nveior
驶	akorrr
歉	yaouor
疏	threur
咽	kqiueo
丘	qoieie
矣	cvoeeo
叛	jaurrr
巫	lforor
兹	apuurr
蜜	vloiue
娅	mseiir
饶	ppeuoe
狄	pproor
漆	ntorir
腐	ajeiri
辣	nzeiue
笨	lteeee
奸	mneeii
嫌	myroeu
僵	jjiuei
逻	cbrurr
吊	kyiuii
脾	hdoiue
仓	dguuuu
舟	pooure
胶	hqorrr
囊	bheeii
逆	srrurr
寓	vwiuie
挖	gduuuu
宴	vwuoee
刷	zyiiii
孝	fsuiee
乾	xvuuuu
肌	haouuu
捏	gweiee
屠	zfeieo
患	kvrurr
尉	zseirr
驰	aduiuu
翁	cyureu
闯	fauuee
滋	nauuru
贪	qdiuor
骇	ahreuo
纱	xvioro
泡	nkueuu
迁	nrrurr
鹤	qmouru
芙	fjeeor
耻	yhieie
邮	ayuiii
饱	pkueuu
捧	gleeii
裙	hciuee
叉	fjrrrr
黛	bxiuro
搂	gquoee
煞	xnrrrr
哩	kgiuee
循	faeiiu
筋	lhuooo
砸	dviuii
廉	ayroeu
陛	ymeiee
档	tcueee
盒	cciuii
艰	fhueeu
剪	asuooo
债	jxiuor
役	fdouur
绵	xdiuii
膝	htorir
抑	gpuiii
畏	gjuorr
棒	tleeii
呈	kseeie
厦	adiuee
吩	ksoruo
渴	nwouor
嘲	kxouee
绩	xxiuor
励	awuooo
灌	nfiuei
乳	ysuuuu
爪	yooirr
杖	tdrrrr
蠢	lwiuei
盼	bsoruo
籍	ldeiie
妥	ymuoee
卜	lirrrr
舅	tguooo
颊	wdeoiu
敦	gsoeor
喉	kjueoe
苗	fgiuei
咳	khreuo
栏	taeeee
帘	dyiuii
颈	pneoiu
拓	gdeoiu
汪	nseeie
秒	cvioro
瞒	bfeiuo
杆	tneeii
宙	vaiuei
览	lfiuou
寨	hteior
契	xseorr
掏	gkoeei
址	lhieie
翰	xdureu
彭	awoooo
毅	hhouur
惟	hmoire
稿	cgiuee
棉	tdiuii
潘	nmiuei
妨	mmreuo
漏	nzeiui
纠	xbuiii
谨	syeiie
柴	tteior
琼	slreiu
珊	ssouee
乙	puuuuu
裹	bweior
宠	vleouo
塑	sheiee
盆	sciuii
殷	acuouu
崖	yaeiee
署	cfeieo
枯	tveiiu
狮	pneiui
霄	pciuee
纽	xauiee
枚	tnoeor
莹	wsrrrr
巷	pgueuu
剂	nniiii
戚	kliorr
遂	whrurr
挽	gwouuu
哑	kseiir
瑶	syoeei
涨	nxoeur
贡	ldiuor
筹	lxeirr
册	sseeee
晋	swiuee
衬	hjeirr
斥	qjrrrr
魄	dsoiue
腔	hdeiee
陌	yjoiue
牺	cteiuo
阅	fkouuu
婴	dduoee
蔡	fyeeio
芝	fkrurr
艘	ptiurr
雀	cmoire
氛	vsoruo
鉴	lvoree
粒	qhrero
甩	hpuuuu
腕	hvouru
绘	xdeeur
姚	mxreor
撕	ggooei
藤	fhroee
胞	hkueuu
咕	kveiiu
昭	wsiuee
谎	sfreuo
婷	mgeiii
辨	nnrero
糖	qaueei
贞	ldiuor
棍	tweuou
倘	jciuiu
谦	syroeu
魅	sdeeio
麟	mqoure
逊	scrurr
骄	afoiii
歪	hkeiei
诡	shuuuu
伪	jjourr
蓉	fdoriu
鼎	bkieiu
蓬	fneeei
钉	vaeiii
郡	ckuiii
妃	mgueuu
薛	fjiueu
冻	wyiorr
骤	ayuroi
沾	ntieiu
塘	laueei
斤	qooeii
馨	lzouur
叠	ffruiu
赴	mlirrr
疆	xleiue
伐	jkeuor
眠	bqueue
禅	hhroiu
渔	ndouiu
赋	djeiei
慨	hteuou
削	chiiii
辽	crrurr
赚	dyroeu
拐	gkuooo
澳	nzroei
哇	kheiee
揭	gwouor
鑫	vvoree
偿	jcruee
倦	jluuuu
玫	snoeor
竭	hwouor
枕	tqouuu
雁	ajoire
菊	dqroei
耍	ymuoee
倩	jheeie
烛	pbiuei
昔	pwiuee
泣	nhrero
遵	djrurr
胳	hzouri
谊	sviuee
辅	yfeiue
叙	qturrr
绣	xcuooo
涯	naeiee
鹿	mreoui
噢	kzroei
俏	jciuee
寇	vlieur
摊	gfoire
翅	pfureu
症	lkeiei
瞥	qniuee
宛	vbuuuu
呜	kkueee
逗	hrrurr
糕	qkrrrr
畅	wjuooo
趋	mxouue
朴	tlirrr
泼	nxuour
账	dboeur
俯	jaoiei
逝	mrrurr
葬	fboueo
讽	saorrr
祈	hqooei
衰	gjouor
樱	tdiuor
拆	mjrrrr
妄	xmuoee
饼	paeoii
筒	lseiue
豹	dkrrrr
揉	gheior
蓄	fbuuri
趟	mciuiu
诊	sdoooo
押	gaiuee
镖	vteeio
嗓	kfurur
绑	xxuiii
淋	nmeior
愕	hheeuu
倚	jkeiue
蜂	bneeei
滨	nvoiei
寞	vyeiii
裸	hweior
尹	cueeoo
弦	xbuurr
坑	lbouuu
滩	nfoire
儒	jpeoiu
谱	saiiro
骚	afriue
朕	haeorr
胎	hciuee
淫	nyoeie
竖	mhrero
蒋	fzoure
恍	hhiroe
哄	kpeiie
鄙	kpiuiu
嫩	mzoeor
舱	pduuuu
践	zkeeuo
劣	vwuooo
萍	yheroe
遣	lhrurr
佐	jdeiee
荆	fniiii
祷	hxeirr
壶	bjiiro
麽	yjurrr
膊	hfeirr
煤	pdeior
冤	qwourr
兮	fweuuu
寡	vdiuee
斑	sneeie
窜	dkiuei
颠	hfeoiu
拱	gpeiie
坠	ydeiee
搁	gfouri
茨	fpreou
惶	hdeeie
磁	dauuru
妆	zmuoee
暮	ywiuee
拂	gxoiii
匠	vqooei
怡	hciuee
晰	wtooei
峡	yworrr
焉	kqrrrr
杭	tbouuu
旨	nwiuee
轿	yfoiii
瑰	ssoiue
顽	lneoiu
瞎	bveeei
猴	pjueoe
兆	xnreor
躬	zxueuu
裕	hforiu
踩	zyeior
盐	lliuii
填	lhorrr
轴	yaiuei
夷	kxueuu
斧	lqooei
涵	ncreor
哟	kxourr
屑	zciuee
晌	wziuee
帆	yarrrr
刮	nniiii
篷	lneeei
攀	thorei
坤	lwiiii
怯	hweieu
谭	stiuee
腊	hpiuee
厢	aveior
钦	vaouor
铭	vbiuee
宰	vnrero
篮	lliuii
陀	yvouuu
仑	aorouu
兔	wxrrrr
烁	ppiorr
匪	vzieee
桐	tseiue
剥	cniiii
堵	lfeieo
俞	qhiiii
棵	tweior
贱	dkeeuo
妒	mtrueo
框	tveeie
眯	bqroei
肆	bsueee
靖	hheeie
诞	sjieuu
赔	dhiuee
浸	ncruur
蹲	zdeirr
裳	cjreou
惩	fkrurr
钩	vkurrr
吁	kaeeii
诀	svorrr
梳	txoiuu
聂	yfurur
钥	vhouee
浙	nmeieo
搏	gfeirr
雇	tmoire
诧	svoeuu
灿	pyiuii
浦	nfeiue
窃	dnuooo
嫣	mkeurr
鲍	dkueuu
衷	bvouor
丸	gjrrrr
泊	ndoiue
陡	ymeiei
桶	tturiu
躁	zkiuei
蓦	yauuee
胃	ghiuee
咯	kzouri
姻	mqiueo
砰	dheroe
崩	yhouee
耿	yproor
钧	vkreee
茂	fkeouo
恕	mkrurr
佑	jdiuee
抄	gvioro
隶	cnireo
罕	qfeeii
凛	wbiuiu
驳	ahorrr
茵	fqiueo
匙	snouuu
萝	wbourr
凰	adeeie
岚	yaorrr
亨	gcuiii
桩	taeiee
掀	maouor
侄	jgeure
斋	nyeoiu
贷	bdiuor
畜	bpiuei
侦	jliuor
哨	kciuee
憾	hkeiue
庸	asiuee
恳	hlrurr
栗	tteior
啪	kgoiue
尴	xliuii
绅	xwiiii
弘	xcurrr
携	gmuooo
履	zfoeiu
挪	gsuiii
狭	pworrr
轨	ygouuu
茅	fhurui
坟	lnreor
嘶	kgooei
赠	dwroiu
叮	kaeiii
撇	gqoeor
龟	dwuuuu
芸	fmeeur
後	fporou
撼	gkeiue
拢	gleouo
汝	nmuoee
倏	jneorr
霉	pvuure
溢	naoriu
靴	qyoiou
壳	baouuu
尬	xdoiii
笛	laiuei
悍	hweeii
乞	vpuuuu
肿	hviuei
葡	dfeiue
烫	ntooro
宪	vgoeie
肢	hpurrr
嘱	kzoiue
隙	yciuee
啥	kqeiiu
翎	qyureu
忖	hjeirr
碑	ddoiue
裴	zjreou
浆	zbiuor
艇	psurrr
娱	mkeeor
擒	gdreor
犬	peorrr
斌	njeiei
羡	kpreou
窄	dzoeie
拘	gkiuee
沐	nteior
盲	xbiuee
旭	gwiuee
郊	qhuiii
垫	dleiee
栽	qteior
捐	gkiuee
磊	ddeoiu
哗	kyeiii
芦	ftrueo
辜	vnrero
茜	fteiuo
锡	vwouoo
秃	caouuu
脂	hniuee
棠	cteior
酬	twrrrr
侮	jvuure
媳	mjrurr
咧	kbiiii
鸭	afouru
毯	wproor
坎	laouor
涩	nsriei
淮	nmoire
歹	beourr
骆	azouri
饥	paouuu
膛	hceiee
溃	nliuor
楞	tcreuo
丐	jluuuu
券	lsuooo
逛	psrurr
煌	pdeeie
潭	ntiuee
棚	thouee
黯	xmrero
膜	hyeiii
沧	nduuuu
堤	lsiuee
颖	nceoiu
栈	tkeeuo
耽	yqouuu
噬	kleieo
掷	gaeoru
卒	bfeiii
衍	fneeii
蔽	fqoeor
堕	ydiuee
绒	xkeooo
栋	tyiorr
逍	chrurr
绸	xseiei
涅	nweiee
呐	kliuor
绮	xkeiue
砖	dyurrr
蹄	zhiuii
粘	qtieiu
魁	sweiii
鸦	afouru
棺	tviueu
狡	pqorrr
妓	mpurrr
昧	wdeeio
萄	dyoeei
呻	kwiiii
盔	dpiuii
亩	bgiuei
腻	hkeeiu
厮	agooei
兜	dpueou
孕	wsuiee
敞	csiueo
搅	gniuou
囚	kdorrr
脊	ndiuee
驼	avouuu
巍	ycuoeo
鹅	wfouru
缕	xquoee
滞	nfruiu
矢	voeeor
锤	vzoeie
瞄	bfiuei
痒	lkroee
塌	lwureu
辟	bueoiu
妾	hmuoee
汹	nhuiii
徽	aduuri
嘟	kfuiii
擅	gbiuiu
阎	fdoieu
苹	fheroe
株	tjeeio
榜	threuo
盏	kciuii
敛	qmoeor
廖	ayoroo
咪	kqroei
妞	mauiee
掘	gzuiiu
汁	npeiii
娟	mkiuee
澡	nkiuei
罐	yfiuei
勋	kduooo
彦	haoooo
焕	pdiueo
呃	kauuuu
蕴	fxiuee
耕	dyeeoi
俺	jkiuee
荪	fsiorr
灼	pkrrrr
冉	sleiee
扁	tliuei
喧	kveiue
摧	gyoire
蒸	fcuore
诈	szoeie
杏	tkiuee
碌	dcireo
殖	bheiiu
嵌	ydouor
捡	gqrroe
邱	qyuiii
姥	mfouuu
郝	cyuiii
璇	sduieo
辕	ynouor
厄	aguuuu
绽	xprrue
胀	hboeur
苟	dkiuee
朽	tweuuu
蜀	ckiuei
彬	mwoooo
喻	kqiuee
肺	hjiuii
钓	vkrrrr
纺	xmreuo
峻	ycorou
坪	lheroe
渠	nvueei
窥	djiuou
蜡	bpiuee
咦	kkueuu
霆	psurrr
瑜	sqiuee
缚	xfeirr
硕	dneoiu
枉	tseeie
睹	bfeieo
嫉	mloeeo
熙	qgrrrr
雯	pnreor
肝	hneeii
蛛	bjeeio
瓷	pjeuur
粹	qboror
尧	peuoee
渺	nbioro
暇	wqueie
冈	shorrr
绞	xqorrr
稽	cxroui
贩	daurrr
溅	ndeeuo
喀	kvourr
巢	wweior
胤	jpiuee
琉	sxoiuu
絮	mkuuri
蔑	wkrrrr
瞳	bhiuee
斐	znreor
禀	bxeeio
俘	jyuiee
凳	yhouuu
迭	jjrurr
焚	mproor
泳	njuuor
衔	fveeii
梨	cneior
墅	gheiee
铸	vxeirr
潇	nfueei
伺	jteiue
吱	kpurrr
邵	skuiii
嘎	kdiuee
祁	hyuiii
腥	hwoeei
狸	pgiuee
傍	jhreuo
滔	nyoieu
疫	ldouur
惭	hyooei
畔	gjroee
樊	thorei
帖	ytieiu
阮	yleeou
琦	skeiue
唔	kjiuee
莽	fpeoii
谣	syoeei
淘	nkoeei
蒲	yfeiue
吏	lhorrr
沫	ndeeio
煮	fnrrrr
敖	keeieu
驴	atrueo
熬	knrrrr
晒	wteiuo
捂	gjiuee
幢	yhiuee
陋	yforuu
勿	jouooo
蹈	zyoieu
於	mdrrrr
菱	florou
拚	gceoii
翩	tlureu
婢	mdoiue
虏	dwuooo
澄	nyeiue
乍	zoeiee
沸	nxoiii
嗡	kcureu
啼	khiuii
喔	kzeure
襟	hmeeio
孽	fjiueu
叱	knouuu
炭	ydroor
趴	zforrr
螺	bguuri
窟	dzuiiu
垒	ccurei
卸	vhuiii
捣	gfiuii
砂	dvioro
歧	hpurrr
麒	mgeiie
蚀	pbiuei
侣	jkiuee
绷	xhouee
渗	ncoooo
澜	nfeiue
藉	fdeiie
莺	wfouru
淹	nkiuee
薪	fheior
毙	mbouuu
僻	jbueoi
髅	mquoee
叨	ksuooo
詹	hfreee
迦	trrurr
荐	fduiee
骷	mveiiu
捆	gkeior
嗦	kbuuri
瞅	bcroor
鳞	dqoure
擎	dkoeor
嗤	kyeiue
衙	fjiuee
菌	fkoeio
聘	yaeuuu
膏	gkiuee
遁	apiuee
荫	fyouee
咙	kleouo
嚣	hniuei
朦	hweeou
憎	hwroiu
吨	kbeuiu
删	sseiii
寝	vzueeu
彷	fmreuo
圾	lsourr
旷	wareoo
垃	lhrero
稚	cmoire
夭	foeorr
鞠	qkroei
磕	dwiuii
捞	gwuooo
梭	tcorou
稻	cyoieu
蚁	bnrorr
虞	dkeeor
蹦	zyouee
秩	cjeeor
哉	qkiuee
醋	tpiuee
颂	cneoiu
尿	zniuor
伞	dweiii
胧	hleouo
挫	gfeiee
伽	jtuoiu
兀	jxouuu
梵	marrrr
凸	hieiue
弩	cxueuu
芷	fhieie
禽	dqiuur
炽	pkorrr
屯	beuiuu
翘	pyureu
宵	vciuee
诵	sturiu
彤	sboooo
雍	bpooir
虐	dceuee
炒	pvioro
氧	vkroee
逮	cnrurr
挟	gworrr
菩	fhiuee
匕	nouuuu
猿	pnouor
喇	kziiii
踱	zdurrr
噗	kjroee
溶	ndoriu
舜	ybeuii
奢	kfeieo
袜	hdeeio
熄	pjrurr
啤	kdoiue
橡	twouiu
嘘	kdiiro
弧	xyoour
镶	vbiuei
嗅	kjeorr
嗔	khorrr
禄	hcireo
梧	tjiuee
顷	nneoiu
缆	xliuou
蓓	phiuee
榻	twureu
槐	tsoiue
妍	mneeoi
谐	smoiue
眶	bveeie
挠	gpeuoe
敷	fmoeor
倡	jwiuee
忿	slrurr
揪	gcroor
蝉	bhroiu
屡	zquoee
饺	pqorrr
呕	kmeoru
龚	lpeiie
茹	fmiuee
蝎	bwouor
缎	xgoiee
讥	saouuu
蔓	fwiuii
奎	kheiee
狞	pveiii
揽	gliuou
珑	sleouo
霎	phuoee
暑	wfeieo
婿	mmiuee
哮	kfuiee
嗽	kzouor
铠	vyueuu
眩	bbuurr
钞	vvioro
匀	kwreee
嘀	khiuei
襄	bheeii
蝴	bvouee
珂	sgeiue
阀	fjeuor
锻	vgoiee
嚼	kyiuii
颓	caeoiu
眷	lbiuee
岔	syiuii
廓	aguieu
倪	jtouuu
卦	hlirrr
譬	bsreee
绰	xliuee
诅	sbiuee
谜	sqrurr
狈	pdiuor
咏	kjuuor
陕	yworrr
肘	hjeirr
梢	tciuee
诛	sjeeio
琐	sciuor
侨	jfoiii
昊	wfeeor
淳	nguiee
桓	tjiuee
旬	kwiuee
揍	gleeor
扳	gaurrr
熏	nxiuro
咸	kleiue
栅	tsiuee
纲	xsorrr
旱	wneeii
嗜	kfouiu
掐	gdoieu
舔	nfirrr
瓣	nyrero
棕	tveeio
鸽	cfouru
燥	pkiuei
噪	kkiuei
鞍	qvuoee
滥	nliuii
憋	qnrurr
氓	xqueue
咆	kkueuu
桢	tliuor
窘	dciuee
簇	ldoeeo
涡	nkiuor
蕊	flrurr
霓	ptouuu
箫	lsoior
拧	gveiii
彪	daoooo
凹	hiuiue
伶	jqorru
铅	vaiuee
珀	sdoiue
婶	mviuee
叩	kwuiii
嚎	kgeouo
骏	acorou
鞘	qciuee
拙	gyuiii
拽	gwuooo
苔	fciuee
跋	zdurrr
沌	nbeuiu
搓	gkeiee
瘫	lfoire
沛	njiuii
湛	nguuuu
琢	shrrrr
喽	kquoee
楠	tpiuro
抿	gqueue
坝	ldiuor
咚	knrrrr
壤	lbiuei
晖	wqeuei
槽	tjiuei
窍	dleuuu
娥	mwoeie
诃	sgeiue
撩	gkroiu
裘	wjreou
祺	hgeiie
卵	pjouir
皓	djoeie
沼	nsiuee
芽	faeuio
橱	taeiue
拭	gkeiee
猾	pmiuur
甸	kgiuei
沁	nlrurr
哆	kbourr
笙	lgoeei
札	tpuuuu
缪	xyoroo
炯	psiuee
戳	ymeuor
粥	xqueuu
佟	jnrrrr
戮	ydoooe
剖	hkiiii
奕	pkeorr
缸	yleiee
悯	hfreor
豁	vxiueo
栖	tteiuo
禹	jkiuie
斟	gprrei
揣	gyeoiu
懊	hzroei
沮	nbiuee
迸	anrurr
葫	fvouee
扛	gleiee
闺	fheiee
怅	hboeur
缀	xfurur
邹	xyuiii
丞	cneeee
冀	zgeiie
瞟	bteeio
褐	hwouor
戟	xkeuor
峨	ywoeie
嬷	myourr
犀	znoeei
寥	vyoroo
酿	tjueeu
碟	ddueio
慷	haueei
猩	pwoeei
疚	ltourr
昼	kqiuee
淌	nciuiu
棘	qqeiui
咨	pkiuee
酱	zbeiuo
冶	wciuee
绢	xkiuee
阱	yyeeoi
脯	hfeiue
滤	ndrurr
惫	ngrurr
浇	npeuoe
疤	lguieu
钮	vauiee
萌	fwouee
茱	fjeeio
臀	zpouur
缴	xdreuo
虔	dnreor
葱	fjrrur
瑾	syeiie
杉	twoooo
霖	pmeior
懈	hhuooe
菁	fheeie
圳	lwoiii
觅	yfiuou
沦	naorou
丙	fdorrr
蕙	fjiuee
觑	djiuou
蝇	bkiuee
泻	nqeuee
蜘	bviuee
虾	bleirr
瞻	bhorre
萱	fveiue
藻	ykiuei
庵	akiuee
匣	vaiuee
叭	kforrr
煎	anrrrr
焊	pweeii
敝	qnoeor
佬	jfouuu
蛟	bqorrr
挚	dnoeei
檐	thorre
庐	atrueo
谬	syoroo
绯	xzieee
烘	ppeiie
搀	gwourr
辫	nxrero
蹙	kliori
牡	cleiee
唾	kzoeie
舆	tyeorr
筷	lhueor
樵	tmrrrr
蔬	ftieie
唬	kdouuu
逞	ksrurr
炫	pbuurr
弊	qneoii
忒	klrurr
酥	tcoeio
拣	gyuorr
钰	vsrrrr
簿	lneiue
漾	nkruuo
噜	kdiuee
啧	kxiuor
踉	zjueeu
茄	ftuoiu
浏	nniiii
牟	ccoeei
罡	ckeiei
剔	wjiiii
跄	zduuuu
舵	pvouuu
吭	kbouuu
浊	nbiuei
澈	nxiuee
哧	kceieo
慑	hyurur
铲	vheooo
膨	haoooo
垮	lkeeuu
兑	kxouuu
芮	fliuor
仕	jleiee
霹	pbueoi
韧	jsrrrr
崎	ykeiue
芯	flrurr
拎	gqorru
撰	ggueue
枢	tmeoru
匿	vfeoiu
蝠	bliuei
叟	tjurrr
渣	ntiuee
绫	xlorou
颅	lzeoiu
颁	sneoiu
祀	hgueuu
楣	tziuee
竿	lneeii
逾	qhiiru
腮	hgrurr
厥	asouor
枣	qwrrrr
黝	xpuooo
窒	dgeure
聋	lyeiie
蔚	fzeeio
嗨	knoeuu
拇	gvuure
砚	dfiuou
僚	jkroiu
闸	faiuee
芭	fguieu
蛊	bciuii
锈	vcuooo
惕	hwouoo
讪	syiuii
瘤	lpiuei
晤	wjiuee
蛙	bheiee
驭	afurrr
璧	bsrrrr
辖	yveeei
阙	fsouor
媛	myeeou
雳	pauooo
侃	jkoiuu
邸	mjuiii
巳	gueuuu
怠	ckrurr
锣	vcourr
矫	vfoiii
驯	awoiii
讳	sjeeui
蔷	fproei
灶	pleiee
搔	gfriue
呸	kheeee
兢	vxeiiu
鬓	bvoiei
肋	hwuooo
诏	ssiuee
镯	vcouiu
娴	mfeior
髓	mdeier
橘	thiuor
棱	tlorou
擂	gpiuei
姗	msiuee
帜	ykorrr
蹬	zyeiue
跺	zaeior
琛	sqorei
筝	lbouue
懦	hpeoiu
翡	zyureu
婪	mmuoee
瘾	lyouue
赎	dpurre
巩	larrrr
钗	vfrrrr
蚕	fbiuei
晏	wvuoee
刁	tjeeee
庇	ameuou
篱	lqiuur
漓	nqiuur
庚	acorrr
轧	ypuuuu
蚂	bauuee
邢	nyuiii
锥	vmoire
熔	pdoriu
叁	cpeeee
嬉	maiuee
茗	fbiuee
驿	afeeii
帧	yliuor
瀑	nweiie
窑	dyoeei
偎	jgeuor
檀	tbiuiu
寰	vceiue
骸	mhreuo
铝	vkiuee
饲	pteiue
铮	vbouue
辐	yliuei
蔼	fsiuee
秉	ccueee
钝	vbeuiu
徊	fxiuiu
阐	fhroiu
惘	hsroer
酋	droeiu
捶	gzoeie
瑛	sfiueo
凿	jkuiii
甄	tleuur
弛	xduiuu
噩	skiuei
洽	ncorei
渝	nqiuee
蟹	hsoeei
窦	dpurre
捅	gturiu
倭	jcuoee
拴	gdeeie
扒	gforrr
砌	dnuooo
咋	kzoeie
玑	saouuu
悼	hliuee
穹	dxueuu
萎	fcuoee
涕	nxroue
绊	xjroee
蚊	bnreor
踹	zyeoiu
峭	yciuee
笃	lauuee
稣	dcoeio
秽	cyourr
贬	djrurr
徘	fzieee
遏	wkorur
睫	bjueei
癌	lkiuei
禾	coeior
揖	gkeiie
潢	npiuei
纬	xjeeui
碳	dyeoro
溺	nxrere
哝	klruou
榆	tqiuee
彰	mpoooo
蹭	zwroiu
歆	maouor
悴	hboror
厕	adiiii
璐	szouri
拯	gcuore
癫	lhoreo
酌	tkrrrr
惚	hjrurr
睬	byeior
瀚	nxorur
驹	akiuee
狰	pbouue
庶	dnrrrr
竺	lyeeee
眺	bxreor
墟	ldiiro
屉	zduuuu
褪	hhrurr
穗	cjiuee
赦	cnoeor
瑚	svouee
歼	bnoeii
颐	qneoiu
啃	khiuee
醇	tguiee
憔	hmrrrr
滕	hlireo
忏	hnoeii
雏	xmoire
泵	dniuor
呛	kduuuu
谴	sliueu
颔	qkeoiu
唧	ktuiii
皂	dneuuu
缄	xkeiue
柬	zwrooo
曙	wceieo
喳	ktiuee
椒	tlioru
叽	kaouuu
踌	zxeirr
祟	yseeio
祠	hteiue
肮	hbouuu
鹃	khouru
朔	shouee
晦	wvuure
悸	hcuiee
靡	yzieee
炳	pforrr
鸾	pfouru
袱	hjeorr
怦	hheroe
娄	qmuoee
氨	vvuoee
硫	dxoiuu
睿	lqeoro
曳	wpoooo
嗳	kyeour
衅	jcroee
唠	kwuooo
倔	jzuiiu
褂	hhirrr
匈	khuiii
勘	gpuooo
傀	jsoiue
锯	vzeiiu
躇	zfeieo
剿	wweior
蟒	bfeorr
缉	xkeiie
玮	sjeeui
妲	mqiuee
俭	jqrroe
粪	qpeiie
髦	bwoeeu
馈	pliuor
贮	dveeee
镑	vhreuo
岑	yqorru
惮	hhroiu
簧	lpiuei
缰	xjiuei
侥	jpeuoe
涤	nneior
贿	ddiuee
谍	sdueio
浣	nveeou
淇	ngeiie
攒	ggoeie
藩	ymiuei
赁	jsiuor
雌	tmoire
沪	ntrueo
拌	gjroee
巅	yhoreo
榴	tpiuei
梗	tbeiue
袅	fjreou
芊	fnoeii
腺	hdiuor
狙	pbiuee
讼	scorur
漩	nduieo
抒	ghurui
啜	kfurur
笠	lhrero
嘈	kjiuei
杠	tleiee
蕉	fmrrrr
剃	xniiii
褚	hfeieo
茉	fdeeio
俐	jciiii
奠	dkeorr
茎	fpurei
绛	xneuii
熠	pyoiue
苇	fjeeui
峙	yleirr
阑	fzrooo
磷	dqoure
肾	mhiuee
儡	jgiuei
冗	qaouuu
恬	hnoeii
妩	mjeouu
毋	vuuoee
哽	kbeiue
厘	agiuee
蝙	btiuei
膳	hkroei
濑	nzouiu
墩	lguieo
稼	cveouo
曦	wkoeio
恃	hleirr
婕	mjueei
苛	fgeiue
汀	naeiii
窖	djoeie
辙	yxiuee
烙	pzouri
诫	skeoii
筠	lloure
惆	hseiei
炕	pbouuu
溯	nsouee
镰	varoeu
咄	kyuiii
琵	sseuou
磅	dhreuo
炙	bproor
洼	nheiee
邑	kguieu
玖	stourr
涟	nyrurr
疮	lduuuu
帷	ymoire
萦	wduuri
毡	wtieiu
摹	ynoeei
炬	pvueee
猝	pboror
桨	zbeior
坂	laurrr
募	ywuooo
筛	lneiui
飙	ppeorr
缅	xheoiu
涧	nfiuee
恺	hyueuu
戎	kdeooo
鹫	lxrour
睦	blorei
茸	fyeiie
枭	fteior
鸳	bgouru
殆	bciuee
奚	ypeorr
笺	lkeeuo
酣	tdeiie
诬	sloror
嵩	ygiuee
奄	kwuuuu
韶	msiuee
闽	fbiuei
悚	hzeiue
瑕	squeie
谕	sqiuee
俨	jsoooo
袄	hfoeor
亢	baouuu
惋	hvouru
氯	vcireo
匡	vseeie
糙	qjrurr
屿	yqeeee
靓	hfiuou
嗖	ktiurr
淀	nprrue
憨	tyoeor
聆	yqorru
坞	lkueee
粤	zqeuuu
璋	smeiii
槛	tliuii
鬟	bceiue
屎	zqroei
迄	vprurr
畴	gxeirr
蚩	yjiuei
漪	npeore
趾	zhieie
骡	aguuri
桔	tneiei
芜	fjeouu
葵	fyeeor
忡	hviuei
孜	snoeor
隧	yweouo
陨	ykiuor
崭	yyooei
勺	kjrrrr
羁	cquuee
撮	gweiie
抡	gaorou
烹	gcrrrr
揩	gmoiue
圭	heieei
筵	ljieuu
嗒	kforei
掣	vyiioe
咎	nliuee
搐	gbuuri
侈	jbourr
亵	bdouor
腑	haorei
隋	ydeiei
橙	tyeiue
咀	kbiuee
捻	gqrurr
瘟	lwiuii
暧	wyeour
簌	lzouor
苯	fteeee
啰	kcourr
吝	nkiuee
闵	fnreor
惺	hwoeei
卉	pneoii
鲸	dlreiu
掺	gcoooo
睨	btouuu
髯	bseiee
漱	nzouor
嗣	klueiu
碱	dkeiue
拷	gfeuuu
恙	klrurr
靳	qqooei
澎	naoooo
吠	kpeorr
钳	vdeiie
吆	kpuurr
呱	kyoour
肴	hdiuee
缔	xhiuii
蛾	bwoeie
攘	gbiuei
疙	lvuuuu
矜	hqorru
拗	gpuooo
佯	jkroee
萤	wbiuei
汰	nkrrrr
笋	lcueeo
馒	pwiuii
迢	skrurr
冢	qhrrrr
琶	ssuieu
廿	deiiee
沥	nauooo
扼	gauuuu
宦	vqeiue
鸥	mfouru
寅	vjiuei
赘	kdiuor
蜷	bluuuuf
蒜	fseeio
痰	lproor
髻	bneiei
蹑	zyurur
璞	sjroee
垢	laeiue
捺	gkeeio
圃	kfeiue
掳	gduooo
镀	vdurrr
礁	dmrrrr
卤	thorrr
箍	lgeiui
槟	tvoiei
羹	knroee
讷	sliuor
裔	jsoriu
鸠	gfouru
芹	fqooei
桦	tyeiii
畸	gkeiue
遐	qrrurr
薰	fniuro
霏	pzieee
琅	sjueeu
冕	wwouuu
钵	vteeee
馅	pdoieu
磋	dkeiee
涣	ndiueo
缭	xkroiu
渎	npurre
贰	kyiuor
渥	nzeure
翟	ymoire
拈	gtieiu
鸯	skouru
褥	hyeirr
祯	hliuor
栓	tdeeie
荔	fwuouo
筐	lveeie
瘪	ljorou
焱	pproor
乒	qjoooo
涎	njieuu
沅	nleeou
埔	lfeiue
噎	kbeiue
烯	pheoiu
榕	tdoriu
粟	tqroei
菇	fmeiiu
昵	wzouuu
恤	hjiuii
啄	khrrrr
韬	jyoieu
阜	jheiii
孚	ysuiee
桅	thuuuu
炀	ptoooo
荧	wproor
殴	mdouur
暄	wveiue
埠	ljiueu
鹊	pwouru
诣	sniuee
惦	haieiu
蠕	bpeoiu
椎	tmoire
绥	xyuoee
跷	zpeuoe
衲	hliuor
黏	cdireo
傩	jfoire
癖	lbueoi
靶	qguieu
矗	hheiiu
陇	yleouo
锭	vprrue
胥	mhiuee
渍	nxiuor
崽	ygrurr
嚓	kvourr
汲	nsourr
叼	kteeee
锄	vbuooo
囔	kbiuei
羔	knrrrr
莞	fveeou
吮	kcouuu
绎	xfeeii
亥	hreuoo
狩	pveirr
煽	ptureu
炊	paouor
锚	vfiuei
蹋	zwureu
壑	lqeoro
剌	zniiii
薯	wfeieo
昕	wqooei
岱	byiuii
阈	fkiuee
挛	pnoeei
鲤	dgiuee
萃	fboror
鹦	dduoeo
茧	fbiuei
懿	bhreou
恻	hdiiii
岐	ypurrr
谛	shiuii
浚	ncorou
凋	wseiei
甥	gguooo
楷	tmoiue
绚	xkiuee
瞩	bzoiue
窿	dyoure
秤	cheroe
殃	bseorr
癸	yfeeor
隅	ywiuie
铎	vfeeii
钊	vniiii
恂	hkiuee
啐	kboror
铨	vdeeie
鄂	hyuuii
佘	dseeio
舶	pdoiue
胺	hvuoee
瘩	lforei
娼	mwiuee
晁	wxreor
锵	vzoure
貂	dsiuee
肇	tnueee
喏	kfeoiu
殉	bkiuee
酶	tvuure
飕	ahoieu
泌	nloooo
憧	hhiuee
赃	daeiee
炖	pbeuiu
垄	lleiee
柿	tbiuii
玺	asrrrr
胭	hqiueo
扉	tzieee
筱	ljoeor
甭	htouee
铐	vfeuuu
谑	sdeuee
鹭	zzouru
佰	jjoiue
籁	lzouiu
芠	fnreor
瓢	tsoour
汕	nyiuii
梓	tnrero
伫	jveeee
鲨	nvouiu
瞿	bboire
眈	bqouuu
孰	gsourr
驮	akeorr
漉	nmreou
幡	ymiuei
壕	lgeouo
稷	cgorou
蹿	zdiuei
攥	gliuee
烽	pneeei
飒	haorrr
紊	nduuri
渭	ngiuee
幺	puurrr
撅	garoeu
侬	jlruou
枷	ttuoiu
寐	vkeeio
濮	njiiro
霭	psiuee
痊	ldeeie
唰	kziuii
麾	ywoeeu
嗟	kkeiee
喋	kdueio
臻	gloeio
殡	bvoiei
栩	tyureu
幌	ywiroe
乓	qjrrrr
炜	pjeeui
馀	pqeior
醺	tniuro
皙	tqoiue
珏	ssrrrr
烬	pkrrrr
矶	daouuu
痉	lpurei
辗	yzeiie
缨	xdiuor
氢	vpurei
桀	bjeior
嵋	yziuee
迂	arrurr
舷	pbuurr
堰	lviuee
簪	lneuou
虬	bpuuuu
砾	dpiorr
谤	shreuo
垣	ljiuee
袒	hqiuee
邃	dweouo
硅	dheiee
垦	hleiee
锺	vniuee
黔	xqorru
煜	pwrero
哺	kfeiue
戾	tpeorr
忐	llrurr
谒	swouor
簸	lguoiu
峦	pyiuii
犁	cnoeei
攫	gbiuee
戬	sweuor
辄	yyuuuu
碾	dzeiie
撵	gjeeor
饵	pyeiie
谏	szrooo
曝	wweiie
厩	ateuou
鹉	jkieie
馋	pwourr
偌	jfeoiu
忑	llrurr
酪	tzouri
潺	nzuiee
惴	hyeoiu
芥	fdoiii
癞	lzouiu
毓	vvreur
泓	nxurrr
咔	klirrr
蛤	bcorei
皎	dqorrr
邬	kteuii
噤	kmeeio
匾	vtiuei
蟾	bhorre
盎	skiuii
痹	lgiuei
沂	nqooei
阖	fwiuii
悻	hlroee
褶	hyoiue
盂	aciuii
琥	sdouuu
嗷	kkeeie
沽	nveiiu
榨	tdoeie
偕	jmoiue
隘	yaoriu
棣	tcireo
蜒	bjieuu
椭	tyeoiu
硝	dciuee
缤	xvoiei
缥	xteeio
甬	turiue
唆	kcorou
麓	mmreou
昱	whrero
荀	dwiuee
滢	nweeie
瘸	ltiuor
纶	xaorou
腆	haorrr
汛	npeiii
煦	wkiuer
屹	yvuuuu
伎	jpurrr
仟	jnoeii
踞	zzeiiu
蕃	fmiuei
骥	aziuei
臊	hkiuei
帛	dyiuii
筏	ljeuor
瓮	cjeuur
鳄	dheeuu
憬	hwreiu
咫	kkorrr
溟	nqiuee
迳	prrurr
榄	tliuou
苞	dgueuu
稠	cseiei
椰	tyuiii
旌	dgoeei
俟	jcoeeo
捎	gciuee
骰	mdouur
迥	skrurr
跛	zzuoiu
幔	ywiuii
臾	tdorrr
刨	kgiiii
惬	hveroe
舫	pmreuo
睑	bqrroe
铿	vmeiee
骋	aaeuuu
隽	mwuooo
曜	wyoire
婊	mxouor
铛	vcueee
掂	gaieiu
崆	ydeiee
赂	dzouri
萼	fheeuu
湃	nneeee
黠	xneiei
咻	kjeior
跤	zqorrr
冽	wbiiii
纨	xgrrrr
唷	kxiuee
惰	hdeiei
猖	pwiuee
羿	yneoii
毗	gmeuou
榭	tzeirr
恣	plrurr
潦	nkroiu
腋	hboiou
呗	kdiuor
褒	bjiuee
淬	nboror
哒	kkrurr
蹊	zyuure
囱	zneeee
袂	hvorrr
胚	hheeee
攸	jnoeor
诲	svuure
璜	spiuei
璀	syoire
峪	yforiu
藕	fdiuee
婵	mhroiu
踝	zweior
盅	vciuii
杳	twiuee
忱	hqouuu
翌	yhrero
篆	laouoo
燎	pkroiu
崛	yzuiiu
濒	nhiooe
钠	vliuor
烨	pyeiii
橄	tteiie
笆	lguieu
滇	nhorrr
缈	xbioro
泾	npurei
沓	nwiuee
扈	tkuieu
鳌	kdouiu
睽	byeeor
仄	adorrr
逵	lfeier
禧	haiuee
卯	pououi
邯	dyuiii
霁	pnoiii
贻	dciuee
珞	szouri
坳	lpuooo
猥	pgeuor
杵	tveiii
撂	ggouri
钙	vjieuu
盹	bbeuiu
淤	nmorrr
豚	hheouo
锢	vkeiiu
蜿	bvouru
酰	tgoeie
酝	tmeeur
圩	laeeii
帚	cqiuii
蜗	bkiuor
茬	fdeiee
瞠	bceiee
啬	paiuiu
瀛	nyuoee
腼	hheoiu
蜥	btooei
湄	nziuee
啾	kcroor
拄	gkreei
亘	jqiuee
羲	kceueu
篓	lquoee
坍	lsreee
骼	mzouri
蚤	fjiuei
珈	stuoiu
涮	nziuii
慵	haueei
孺	speoiu
嫖	mteeio
踵	zniuee
聿	sueeee
衾	qjreou
蟆	byeiii
皋	dkeiii
卞	jleirr
飓	aheuee
翊	hyureu
闩	fjeeee
脓	hlruou
镣	vkroiu
箕	lgorrr
壹	bheiue
呷	kaiuee
溉	nteuou
胄	ahiuee
瑙	swoiuo
驸	ajeirr
悖	hbuiee
馥	cwoeiu
捋	gyeirr
镕	vdoriu
娓	mzoeeu
磺	dpiuei
苓	fqorru
痪	ldiueo
酉	teiuou
懵	hwruiu
衮	qcouor
辘	ymreou
夙	abeour
粱	nsrrro
宸	vyeoee
姣	mqorrr
汾	nsoruo
嫡	mhiuei
蘑	fyeoiu
暨	tniuee
檬	tweeou
戊	keouor
颌	cneoiu
秧	cseorr
璨	slouro
渲	nveiue
饷	pziuee
咂	kviuii
丕	hjeeee
赣	mpoure
晟	wkuuuu
掬	gkroei
遽	dhrurr
螂	bjueeu
笈	lsourr
柠	tveiii
蛰	dbiuei
嚅	kpeoiu
蜈	bkeeor
痞	lhiuee
荤	wyeuei
峒	yseiue
咛	kveiii
蟠	bmiuei
瞌	bwiuii
汩	nkeeee
瞑	bqiuee
熹	akrrrr
搪	gaueei
囡	kmuoee
飚	ahroor
倌	jviueu
恁	jsrurr
偃	jviuee
臧	kkeiue
讹	syoiou
玷	stieiu
戍	kjrrrr
莓	fvuure
蓟	fdiiii
跚	zsiuee
龛	cleouo
俸	jleeii
魇	apoiue
隼	mpeiii
酵	tfuiee
撬	gwoeeu
疵	ltieie
疹	ldoooo
泞	nveiii
颚	hyueoi
蝗	bdeeie
侏	jjeeio
鼾	jgeeii
徨	fdeeie
翱	dkeiur
荃	fdeeie
浒	nsoeei
蘸	ftoire
臆	hmrurr
噙	kdreor
嗫	kyurur
螃	bhreuo
胯	hkeeuu
纫	xsrrrr
瘴	lmeiii
潼	nhiuee
膺	ajoire
磐	pdeoiu
嘤	kdiuor
啷	kjueeu
劭	skuooo
诽	szieee
槌	tjiueu
抉	gvorrr
剁	atiiii
篝	lpiuei
瞰	bteiie
怆	hduuuu
酯	tniuee
堇	yeiiei
噘	karoeu
蹩	qniuei
蹂	zheior
馁	pyuoee
弼	xjoiue
鞑	qkrurr
骁	apeuoe
蔗	fdrrrr
樟	tmeiii
轶	yjeeor
绺	xniriu
篡	lbeoru
汶	nnreor
葆	psiuee
涓	nkiuee
氮	vproor
谚	sheooo
蚣	bcorur
掰	nsoeei
掖	gboiou
蹒	zfeiuo
靥	apeoiu
熨	zseirr
憩	njrurr
亟	ckuree
鬃	bveeio
虱	pjiuei
晾	wlreiu
垛	laeior
嫔	mvoiei
鬈	bluuuu
嫦	mciuii
捱	gaeiee
绉	xxouue
彝	aquuri
刽	dmiiii
颦	hceoiu
嗬	kforei
糜	yqroei
豺	dteioo
舐	nmoueu
嬴	ymuoee
蕨	faroeu
掸	ghroiu
鳖	qnouiu
羌	kpuuuu
纣	xjeirr
敕	znoeor
阉	fkiuee
谄	sdoieu
恸	hmuooo
娣	mxroue
鹄	jfouru
艮	hueeuo
嗥	kdeore
佃	jgiuei
嘭	kaoooo
躏	zfriuo
喟	kgiuee
蚌	bxeeei
皖	dveeou
娲	mkiuor
诩	syureu
恪	hzouri
蜕	bkouuu
樽	tdeirr
腌	hkiuee
俾	jdoiue
娑	nvuoee
坯	lheeee
椿	tliuee
藐	fdoiue
碴	dtiuee
抠	gmeoru
纂	lbeoru
涔	nyorru
酮	tseiue
诘	sneiei
杞	tgueuu
昙	wmeeur
辊	yweuou
芍	djrrrr
耘	dmeeur
烷	pveeou
郢	ksuiii
谩	swiuii
褛	hquoee
罔	sareuu
梆	txuiii
裟	nvreou
濡	npeoiu
饯	pkeeuo
袈	tjreou
怂	flrurr
谧	sloiui
町	gaeiii
莘	fnrero
芋	faeeii
嵇	cxriui
匝	vyiuii
舀	ytoieu
宓	vloooo
娉	maeuuu
锌	vnrero
湍	nyeoiu
鸵	fvouuu
涸	nkeiiu
孵	pjouir
沏	nnuooo
唏	kheoiu
吒	kjeuuu
龊	hkieor
愫	hxuuri
噼	kbueoi
龌	hzeure
闰	fseeie
橇	twoeeu
澹	nhorre
徙	fhieor
耦	dwiuie
褴	hliuii
漳	nmeiii
镂	vquoee
氟	vxoiii
擞	gquoeo
竣	hcorou
殇	bvuooo
痣	llrurr
谪	shiuor
脐	hnoiii
犊	cpurre
谙	smrero
皑	dyueuu
渤	nbuieu
斫	dqooei
泗	nkouuu
蒿	fgiuee
掇	gfurur
淆	nheoiu
颉	nneoiu
釜	lnroee
赈	dyeoee
耷	kyeiie
睐	bwiorr
捍	gweeii
佗	jvouuu
踊	zturiu
茴	fxiuiu
睇	bxroue
嚏	kbiuei
孢	skueuu
媲	mzoree
荼	fqeior
窈	dpuooo
柒	nneior
塾	gsoure
颀	qneoiu
逅	alrurr
榈	tfiuei
岖	ymeoru
恿	tlrurr
赊	ddeeio
瘁	lboror
淄	nwiuei
佼	jqorrr
胫	hpurei
泷	nleouo
耙	dguieu
禺	wliuie
岌	ysourr
宕	vdeoiu
匍	kfeiue
隍	ydeeie
菠	yzuoiu
邂	hsoeei
谟	syeiii
汴	njeirr
咿	kjueeo
粲	lburro
碘	daorrr
妪	mmeoru
噫	kmrurr
谆	sguiee
羚	kqorru
泯	nqueue
孀	mpeior
缜	xhorrr
怏	hseorr
鳗	dwiuii
邝	ayuiii
粼	qbeuiu
烩	pdeeur
渚	nfeieo
摒	gzroee
婀	myeiue
骠	ateeio
獠	pkroiu
闫	fpeeee
肪	hmreuo
翦	ayureu
蜻	bheeie
戛	dbeuor
僮	jhiuee
颧	fhoire
赧	cwurrr
蠹	bdiuei
藜	fcouoo
湮	nteiee
榛	tloeio
娆	mpeuoe
锹	vcroor
覃	tweiii
蜴	bwouoo
鸨	npouru
瓯	mjeuur
挲	nvoeei
揄	gqiuee
巽	ggeiie
楔	txuoeo
壬	soeiee
涝	nwuooo
赡	dhorre
荟	fdeeur
愠	hwiuii
啻	hyiuee
珉	squeue
挹	gkuieu
踮	zaieiu
诌	sxouue
绾	xviueu
垠	lhueeu
觞	hvuooo
谀	storrr
臼	toieue
呓	kfuuuu
濂	naroeu
阪	yaurrr
闾	fkiuee
皿	ciuiie
麝	mzeirr
衢	fbiuee
濯	nyoire
殓	bqrroe
镔	vvoiei
郸	hyuiii
淼	nniuor
镐	vgiuee
窕	dxreor
昀	wkreee
噶	kfiuee
贲	pfiuor
霈	pneiui
柑	tdeiie
镌	vmuooo
钾	vaiuee
摺	gyoiue
挎	gkeeuu
辍	yfurur
蜃	ybiuei
蛆	bbiuee
菀	fvouru
弈	pneoii
髭	btieie
蜓	bsurrr
洱	nyeiie
荻	fproor
骈	aaeoii
羟	kpurei
箩	lcourr
辇	jjeuei
惇	hguiee
邋	wkorur
坷	lgeiue
啮	khieie
腴	htorrr
楫	tkeiie
剐	kliiii
孪	psuiee
俪	jceiur
颍	nneoiu
啕	kkoeei
雹	pkueuu
霾	pdiuee
雉	vmoire
狒	pxueuu
匐	kliuei
琨	sweuou
瘀	lmorrr
琏	syrurr
峥	ybouue
哂	kteiuo
铀	vaiuei
戌	kjeeee
迩	arrurr
虻	bxreuu
瘠	lnoriu
旖	dkeiue
忸	hauiee
阂	fhreuo
籽	qsuiee
坨	lvouuu
蜚	zbiuei
榔	tjueeu
粽	qveeio
诙	sdroor
搽	gforei
耆	fniuee
骊	aceiur
辔	xyuuei
琰	sproor
晔	wyeiii
犷	pareoo
赳	mbuiii
谗	swourr
诠	sdeeie
箴	lkeiue
酗	thuiii
菡	fcreor
蔻	fveeou
弑	hteure
堑	yqeiee
浜	nqorrr
槁	tgiuee
怩	hzouuu
咤	kvoeuu
佻	jxreor
缇	xsiuee
睾	jceiee
垭	lseiir
卅	jwoiii
讫	svuuuu
斛	hweiii
懋	theior
倜	jseiei
斓	nfeiue
恫	hseiue
迤	vdrurr
淞	ntorur
彗	xxueee
仞	jsrrrr
琬	svouru
喵	kfiuei
胴	hseiue
篙	lgiuee
噔	kyeiue
鲲	dweuou
淅	ntooei
殒	bkiuor
嶙	yqoure
鳅	dcroor
痘	lheiue
潍	nxoire
泠	nqorru
颏	hneoiu
遢	wyrurr
腓	hzieee
洵	nkiuee
欤	qjouor
邺	jyuiii
蟋	bmrurr
螳	bceiee
饨	pbeuiu
摈	gvoiei
峋	ykiuee
沱	nvouuu
谲	shiuor
诋	smrrrr
犄	ckeiue
泸	nlueoo
匮	vliuor
屐	zfeiur
呦	kpuooo
柩	tvourr
龇	htieie
诮	sciuee
翳	vvouur
橹	tdiuee
嗝	kleiue
盥	tniuii
棹	tliuee
桧	tdeeur
忤	hveiii
鹞	yyouru
秆	cneeii
鄱	mguiii
蹇	hkieor
蟀	bbuurr
蛀	bkreei
剽	tsiiii
糗	qjeorr
淙	nveeio
饪	psoeie
绡	xciuee
祗	hmrrrr
藓	fdroee
岷	yqueue
钹	vdurrr
钛	vkrrrr
抨	gheroe
嵘	yweior
馍	pyeiii
婧	mheeie
遑	dsrurr
俎	fbiuee
苷	fdeiie
嘹	kkroiu
佞	jyuoee
濠	ngeouo
刍	xouuee
挝	gjrurr
骅	ayeiii
窠	dweior
咝	kpuuee
臃	hbuuoo
糠	qaueei
馄	pweuou
斡	xdrrei
绶	xyurrr
煲	jsroor
蔺	ffoire
弁	cneoii
囗	kiueee
滂	nhreuo
兖	qcouuu
鸪	vfouru
聒	ynoeii
箸	lfeieo
牒	kdueio
跻	znoiii
豌	hvouru
觊	ygiuou
牍	kpurre
栾	pteior
忻	hqooei
嗲	klouro
诳	speeie
俑	jturiu
镁	vkeorr
觎	qhiiiu
胰	hkueuu
箔	lnoiue
怵	htrrrr
寮	vkroiu
喙	kaouoo
劾	hwuooo
焙	phiuee
滟	nxouui
挞	gkrurr
妤	mhurui
韭	zjeeee
绦	xneior
猬	pgiuee
灸	tproor
鸢	kfouru
茁	fyuiii
潞	nzouri
揶	gyuiii
鹑	gsouru
磬	lzouur
氲	vwiuii
岫	yaiuei
蹶	zaroeu
膘	hteeio
瑁	swiuee
氅	csiueo
鹧	dnouru
酊	taeiii
蜍	bqeior
皈	daurrr
汐	nbourr
佚	jjeeor
馏	ppiuei
銮	pvoree
辎	ywiuei
釉	maiuei
玳	sjeurr
旎	dzouuu
叵	vkiuee
陂	yzuoiu
裱	hxouor
祛	hweieu
嵬	ysoiue
偻	jquoee
漕	njiuei
呶	kmurrr
鹳	fhoire
蚓	bxiiii
黍	cdireo
顼	sneoiu
砧	dtieiu
弋	keurrr
咭	kneiei
娩	mwouuu
疡	ltoooo
疟	lceuee
徇	fkiuee
徵	aseeie
饕	kwieuo
肛	hleiee
吡	kmeuou
玟	snreor
猷	dpeorr
啶	kprrue
唁	ksreee
讴	smeoru
孑	suieee
姝	mjeeio
觐	yfiuou
裆	hcueee
鹗	hyuour
鳝	dkroei
鲈	dlueoo
骛	hnuuee
痨	lwuooo
鹂	cfouru
蠡	ahiuei
畦	gheiee
汞	lniuor
铰	vqorrr
钜	vvueee
胱	hhiroe
悒	hkuieu
鳍	dfouiu
嘁	kkieei
蟑	bmeiii
秸	cneiei
栉	tfuiii
帏	yjeeui
嗑	kwiuii
诰	sjoeie
橐	bdeior
箐	lheeie
泱	nseorr
媪	mwiuii
俚	jgiuee
黜	xyuiii
潸	nmiuee
柚	taiuei
恹	haeorr
绔	xkeeuu
囤	kbeuiu
螭	bqiuur
獗	paroeu
狎	paiuee
呲	ktieie
稹	chorrr
嫫	myeiii
韫	jwiuii
熵	phiuor
搡	gfurur
懑	nfeiuo
飨	pjorru
靼	qqiuee
赭	cfeieo
豢	lheouo
侗	jseiue
蚯	bqoiei
纾	xhurui
孱	zsuieu
驷	akouuu
畹	gvouru
滓	nvrero
傥	jcouuu
骜	kauuee
礴	dyeiue
畿	ppeuor
氤	vqiueo
掴	gkeeie
俦	jxeirr
罹	choire
箝	lgeiie
笞	lciuee
砥	dmrrrr
倨	jzeiiu
轼	ykeiee
缮	xkroei
酚	tsoruo
荏	psoeie
琮	sveeio
椽	taouoo
夥	wtouro
圜	kceiue
钿	vgiuei
砺	daeuoo
鲶	dqrurr
蛐	baiuei
爿	kuieoo
浃	nworrr
诿	scuoee
祢	haouio
祚	hzoeie
仃	jaeiii
钺	vkeuuo
轭	yauuuu
蓑	fgeouo
葳	fkeuoe
眦	btieie
唑	kfeiee
魑	sqiuur
阕	fyeeor
镫	vyeiue
荞	ffoiii
痢	lciiii
獭	pzouiu
燧	pweouo
溧	nteior
饬	pvuooo
炷	pkreei
庾	atorrr
镍	vjeior
遨	krrurr
骞	hauuee
遛	pgrurr
扪	gfriuu
裨	hdoiue
摞	gguuri
嗄	kdiuee
铢	vjeeio
喁	kwiuie
鹘	mfouru
馔	pgueue
肽	hkrrrr
淖	nliuee
帼	ykeeie
婠	mviueu
榷	tqoire
镳	vmrrrr
豕	heouoo
碉	dseiei
荚	fworrr
溥	nfeirr
咩	kkroee
僭	jneuou
锉	vfeiee
酩	tbiuee
蹴	zleour
胛	haiuee
眇	bvioro
庠	akroee
灏	nwreiu
昶	jtuori
揿	gvouor
翕	cyureu
罄	lzouur
嫚	mwiuii
趄	mbiuee
醛	tforee
蛎	baeuoo
糯	qpeoiu
溴	njeorr
幄	yzeure
夯	kwuooo
傧	jvoiei
锏	vfiuee
铣	vgoeie
桠	tseiir
剜	vbuuii
佥	qmrroe
谥	saoriu
矾	darrrr
忪	hcorur
檄	tdreuo
捌	gkuoii
鱿	dxrrrr
锰	vsiuii
钏	vwoiii
哔	kmeiii
麋	mqroei
肱	hdurrr
伧	jduuuu
烃	ppurei
湎	nheoiu
欹	kgouor
摁	gqrurr
庖	akueuu
鲑	dheiee
赍	pfruiu
萋	fjueei
犒	cgiuee
幂	qweorr
饽	pbuiee
邈	ddouru
螓	bloeio
夔	ajieie
闳	fdurrr
镭	vpiuei
泅	nkorrr
岬	yaiuee
莅	phrero
箬	lfeoiu
珩	sfeeii
牝	cnouuu
扞	gneeii
荑	fkueuu
鸷	dfouru
嶂	ymeiii
宥	vdiuee
靛	hprrue
阡	ynoeii
邙	xyuiii
蝼	bquoee
罅	ydoroe
涪	nhiuee
拮	gneiei
蘅	ffouiu
葶	fgeiii
玎	saeiii
埂	lbeiue
棂	tcroor
挈	xsoeei
奁	kmeoru
龈	hhueeu
鲫	dtuiii
踅	mkieor
姮	mjiuee
餮	bdoooo
阒	fbeorr
鄢	kqrrrr
逦	crrurr
诶	scoeeo
裾	hzeiiu
罂	ddoeei
粑	qguieu
稔	cqrurr
珅	swiiii
痫	lfeior
燮	sproor
滦	npeior
撷	gneoiu
啖	kproor
厝	apiuee
蛹	bturiu
绌	xyuiii
氰	vheeie
楂	ttiuee
咣	khiroe
陲	yzoeie
闱	fjeeui
莆	ffeiue
擢	gyoire
弭	xyeiie
邕	wkuieu
荥	wniuor
灞	npeiie
偈	jwouor
袤	bhouor
煨	pgeuor
轲	ygeiue
蹰	zaeiue
诨	sqeuei
汨	nwiuee
擤	gjiuei
凫	faouuu
亓	jjeoii
箧	lveroe
睥	bdoiue
馊	ptiurr
膻	hbiuiu
缙	xsiuee
浔	nceirr
殁	bdouur
柘	tdeoiu
忝	fcirrr
勖	wbuooo
鹌	kwuour
锃	vkeeie
褓	hjiuee
瓒	sgoeie
塆	lpueuu
螫	cniuei
峤	yfoiii
铬	vzouri
葩	fduieu
纡	xaeeii
槎	tkeiee
岙	fyiuii
姘	maeoii
阗	fhorrr
衿	hqorru
纭	xmeeur
殛	bciueu
楮	tfeieo
枸	tkiuee
刎	jniiii
鲛	dqorrr
躅	zcouiu
蠊	baroeu
怄	hmeoru
崴	ykeuoe
驽	cauuee
佝	jkiuee
襁	hxiuei
涿	nhrrrr
猢	pvouee
楹	twuriu
雠	msoire
铆	vpouou
缢	xaoriu
睢	bmoire
狷	pkiuee
噻	kheiee
璎	sdiuor
铡	vdiiii
疽	lbiuee
瑭	saueei
铄	vpiorr
蔫	fkeurr
暝	wqiuee
喑	kmrero
魍	ssroer
蓼	fyoroo
甯	vliuee
啭	kyeeur
杷	tguieu
逡	cfourr
苜	fbiuee
羸	ykroee
嫒	myeour
伉	jbouuu
邨	byuiii
笏	ljouoo
疣	lxrrrr
毂	byouur
讣	slirrr
粕	qdoiue
蹉	zkeiee
跎	zvouuu
脍	hdeeur
揆	gyeeor
鳃	dgrurr
泫	nbuurr
杓	tkrrrr
杈	tfrrrr
鳕	dpueee
辂	yzouri
诟	saeiue
蝌	bcrrei
獐	pmeiii
桁	tfeeii
栎	tpiorr
栀	taeuuu
妊	msoeie
隗	ysoiue
讵	svueee
痔	lleirr
珣	skiuee
梏	tjoeie
撺	gdiuei
苣	fvueee
鏖	mvoree
诓	sveeie
誊	lsreee
抻	gwiiii
嘣	kyouee
铵	vvuoee
舂	ltoieu
骧	abiuei
钣	vaurrr
繇	yyouur
癣	ldroee
瘘	lquoee
榉	tmoree
彀	bjueuo
蕲	fhooei
崂	ywuooo
噌	kwroiu
锲	vxuoeo
蚱	bzoeie
牦	cwoeeu
煊	pveiue
暹	wmrurr
懔	hbiuiu
愆	fneeir
醮	tmrrrr
笳	ltuoiu
趔	mbiiii
诒	sciuee
褡	hforei
羯	kwouor
猱	pheior
娠	myeoee
鸶	ppeour
芩	fqorru
掮	gtiuee
囿	kdiuee
儆	jfouiu
侩	jdeeur
仝	dleiee
蛔	bxiuiu
耄	fnoeeu
琊	sauiii
恽	hqeuei
姒	mburor
鸩	qxouru
醚	tqrurr
绻	xluuuu
忾	hvoeeu
碣	dwouor
獒	kpeorr
桡	tpeuoe
掼	gviuor
囵	kaorou
芪	fmoueu
箓	lcireo
牖	kteiue
濛	nweeou
澧	naeiue
鳏	dcioor
菖	fwiuee
苋	ffiuou
蒺	floeeo
篑	lliuor
潋	nqrroe
汜	ngueuu
徕	fwiorr
孬	hmuiee
唳	kteorr
酡	tvouuu
遒	drrurr
踯	zaeoru
苒	fseiee
纰	xmeuou
祉	hhieie
砷	dwiiii
柢	tmrrrr
哐	kveeie
腭	hheeuu
鬣	bwiueo
茛	fhueeu
瑗	syeeou
戕	kkeuor
愎	hviuee
悌	hxroue
呤	kqorru
铉	vbuurr
轸	ydoooo
觥	hhiroe
蚪	bweiii
壅	bpooir
噱	kdeouo
阚	fteiie
铤	vsurrr
辚	yqoure
踽	zjiuei
貉	dzouri
谯	smrrrr
佶	jneiei
魈	sciuee
葭	fqueie
瑷	syeour
焖	pfrurr
郜	jyuiii
磔	dbeuie
狲	psiorr
桎	tgeure
垩	sleiee
牯	cveiiu
沣	nxeeei
枇	tmeuou
舸	pgeiue
腱	hsurrr
嫱	mproei
傣	jlireo
伢	jaeuio
舢	pyiuii
姹	mvoeuu
魉	sforor
螯	kbiuei
薮	fquoeo
艄	pciuee
廪	abiuiu
蓁	floeio
缱	xliueu
篁	ldeeie
桉	tvuoee
杼	thurui
鸱	mjouru
霰	ppiuee
闼	fkrurr
逋	frrurr
蒯	fhouee
鹜	hnouru
颢	wleoiu
颛	ypeoiu
锷	vheeuu
钯	vguieu
蚜	baeuio
奂	dseorr
哞	kcoeei
贽	ddiuor
铳	vxouuu
臬	jteior
墉	laueei
埭	lcireo
讦	sneeii
蓿	fvoreo
硷	dqrroe
畈	gaurrr
崧	ytorur
醴	taeiue
踟	zviuee
赝	ajoire
秣	cdeeio
犟	xkiuei
爰	yjeour
拊	gjeirr
僖	jaiuee
谌	sguuuu
疱	lkueuu
嗵	ktrurr
乩	tpuuuu
鲷	dseiei
郦	cyuiii
茏	fleouo
磴	dyeiue
槿	tyeiie
娌	mgiuee
妯	maiuei
鳟	ddeirr
盱	baeeii
冼	wgoeie
郴	myuiii
炔	pvorrr
唿	kjrurr
蜢	bsiuii
圻	lqooei
卟	klirrr
魃	sdurrr
谡	sgorou
俅	jweire
轾	ygeure
薜	fbueoi
莒	fkiuee
砒	dmeuou
烊	pkroee
搦	gxreue
齑	nnieee
邳	hjuiii
螟	bqiuee
徉	fkroee
陟	yhiooo
钨	vkueee
蛱	bworrr
竽	laeeii
枞	tforor
搴	hnoeei
恚	hlrurr
媾	mpiuei
谔	sheeuu
蚝	bwoeeu
茯	ppeorr
膑	hvoiei
硼	dhouee
擘	bnoeei
撸	gdiuee
悭	hmeiee
幛	ymeiii
鬻	xqueue
阆	fjueeu
螨	bfeiuo
舛	bjeuii
鳚	dzeeio
骓	amoire
锟	vweuou
铂	vdoiue
跖	zdeoiu
矍	bboire
邛	lyuiii
逖	pprurr
葺	fkeiie
苄	fjeirr
眙	bciuee
湫	ncroor
鼹	twrruu
癯	lbiuee
旃	dsreee
垸	lveeou
诤	sbouue
蛭	bgeure
殚	bhroiu
邡	myuiii
跆	zciuee
莠	fcuooo
樾	tmeuuo
囹	kqorru
啁	kseiei
亳	gjeuuu
乜	tpuuuu
鼬	taiuei
羧	kcorou
鄞	yyuiii
簟	ltiuee
瞽	apuriu
猊	ptouuu
犸	pauuee
奘	kleorr
骢	azoure
雒	zmoire
铧	vyeiii
缟	xgiuee
睚	baeiee
镞	vdoeeo
玥	shouee
槊	sheior
怫	hxoiii
綦	gduuri
搠	gsouee
寤	vkeiue
啵	knuoiu
酆	yxeeei
狯	pdeeur
湟	ndeeie
徜	fciuiu
醪	tyoroo
衩	hfrrrr
柞	tzoeie
抟	gyurrr
俳	jzieee
砭	djrurr
淦	nvoree
唢	kciuor
呋	kjeeor
黧	ckoiur
茔	wleiee
樨	tzireo
饴	pciuee
衽	hsoeie
珪	sheiee
猡	pcourr
猕	pxouio
曷	wkoruu
轳	ylueoo
蜇	mbiuei
缦	xwiuii
畲	dsiuei
墀	lzireo
钤	vqorru
蕖	yvueei
滘	nqorei
仨	jpeeee
镛	vaueei
戢	kyeuor
囫	kjouoo
荩	fkrrrr
疝	lyiuii
猗	pkeiue
洮	nxreor
尕	wciorr
垟	lkroee
砦	tdeoiu
椴	tgoiee
麴	pdouro
蜮	bkiuee
眬	bleouo
痼	lkeiiu
痍	lkueuu
疥	ldoiii
聩	yliuor
焘	xjrrrr
滁	nyoree
沆	nbouuu
枰	theroe
徼	fdreuo
侪	jnoiii
锂	vgiuee
逶	cmrurr
荠	fnoiii
痂	ltuoiu
怼	fjrurr
阍	fmiuee
錾	yqoree
薨	wqeour
缁	xwiuei
祜	hveiiu
旄	dwoeeu
馗	gaoiue
钴	vveiiu
菏	ygeiue
嗪	kloeio
遴	qbeuir
诂	sveiiu
竦	hzeiue
煅	pgoiee
樯	tproei
骝	apiuei
郗	hdiuiu
赉	wniuor
蝈	bkeeie
薏	fmrurr
萸	ftorrr
菸	fmorrr
菟	fwourr
莴	fkiuor
荦	wcoeei
苕	fsiuee
鹈	xfouru
萘	fkeeio
碜	dcoooo
瘢	lpouur
晷	wniriu
擀	gxoree
鹬	hsoriu
钡	vdiuor
殄	bdoooo
椁	tguiee
扃	tsiuee
鞅	qseorr
镊	vyurur
钎	vnoeii
菅	fviueu
肓	xhiuee
砀	dtoooo
墒	lhiuei
嚯	kpoire
珲	sqeuei
沭	ntrrrr
刈	hniiii
虢	yjieuo
膂	djiuee
缛	xyeirr
笄	lneeoi
岘	yfiuou
骐	ageiie
迨	ckrurr
苫	ftieiu
穰	cbiuei
旯	wgouuu
鹕	vhouru
蚧	bdoiii
矞	hsoriu
旮	gwiuee
旆	djiuii
屦	zfroei
胪	hlueoo
罴	cwrrrr
砣	dvouuu
歙	cyouor
婺	hnuoee
圄	kjiuee
剡	ppiiii
鞣	qheior
蓣	fheoiu
荨	fceirr
洙	njeeio
堞	ldueio
勐	scuooo
骖	acoooo
铙	vpeuoe
讧	sleiee
臌	haeiur
钲	vkeiei
豸	dorrou
訇	ksreee
蚨	bjeeor
硐	dseiue
瑄	sveiue
沤	nmeoru
帔	yzuoiu
垓	lhreuo
蚋	bliuor
爻	hhorrr
渌	ncireo
槭	tkieei
阃	fkeior
酢	tzoeie
薹	fnrueu
芘	fmeuou
毵	cwoeeu
蛩	lariue
莜	fjoeor
碛	dxiuor
夤	bveiue
哚	kaeior
呔	kkrrrr
鲟	dceirr
阊	fwiuee
谶	sfeiee
藁	fgiuee
稗	cdoiue
珥	syeiie
吲	kxiiii
颞	yfeoiu
镬	vfoire
嵯	ykeiee
驺	axouue
镗	vceiee
藿	fpoire
掾	gaouoo
孛	bsuiee
嘬	kweiie
鲇	dtieiu
邰	ckuiii
襦	hpeoiu
蕈	ftiuee
苻	pjeirr
腈	hheeie
甾	wgiuei
晗	wqiuee
垅	lleouo
鼍	hgeiue
鼋	lkiuee
訾	tsreee
蜉	byuiee
蘩	fvuure
舄	tkrrrr
膈	hleiue
疸	lqiuee
疋	muieor
楸	tcroor
髋	mveiii
郅	gyuiii
跹	znrurr
赅	dhreuo
蓍	ffouiu
篦	lzoree
窳	dyoour
呖	kauooo
伥	jboeur
鹚	apuuro
鸫	ycouru
莼	fxeuiu
筮	lloror
珐	sweieu
氐	mjrrrr
栊	tleouo
杲	wteior
郧	kduiii
纥	xvuuuu
屣	zfieie
郄	hdurui
赓	acoriu
脩	jniuee
聃	yseiee
碓	dmoire
疃	ghiuee
爨	tseiue
泮	njroee
榫	tmeiii
喱	kaiuee
傕	jqoire
锗	vfeieo
郓	qyuiii
蹼	zjroee
狻	pcorou
韪	sjeeui
锆	vjoeie
鎏	nxoiuu
诎	syuiii
瓠	kyuoou
涫	nviueu
帙	yjeeor
嶷	ynoeeo
埚	lkiuor
鳐	dyoeei
馐	pkuiee
豉	hpurrr
苎	fveeee
痈	ltouee
怛	hqiuee
啉	kmeior
卮	ajuuuu
仵	jveiii
锜	vkeiue
邾	jduiii
茕	wpeiii
疠	lweuoo
孳	apuuru
鸬	lzouru
鲠	dbeiue
趱	mgoeie
蘧	fdeouo
萏	fdoieu
硒	dteiuo
珰	scueee
獾	pfiuei
仡	jvuuuu
鼙	apuroi
黩	xpurre
谘	spiuee
蠲	afiuii
耋	fneure
碇	dprrue
杪	tvioro
徂	fbiuee
塍	hleiee
蝮	bviuee
虺	jxiuei
蕤	fhoeei
菽	flioru
耒	deeeio
檗	bteior
橼	txuueo
柰	tseeio
垆	llueoo
阄	fdiuee
跗	zjeirr
觯	hhroiu
菰	fsoour
艉	pzoeeu
缃	xveior
篾	lceouo
瀣	nlouru
扦	gnoeii
圉	klroee
凼	nsuiii
麈	mkreei
迓	arrurr
赀	tdiuor
翮	lyureu
禳	hbiuei
痤	lfeiee
甑	wjeuur
愍	qnrurr
彧	kkeooo
餍	aporru
襞	bjreou
縻	yduuri
秾	clruou
淝	nhuieu
氖	vwuooo
兕	hxouuu
锑	vxroue
邗	nyuiii
谵	shorre
裢	hyrurr
犍	csurrr
欷	hdiuio
晞	wheoiu
彘	anoeeo
帻	yxiuor
钒	varrrr
醍	tsiuee
跸	zmeiii
漯	nguuri
洄	nxiuiu
庑	ajeouu
坼	lqrrrr
哓	kpeuoe
踬	zaeiiu
褊	htiuei
腩	hpiuro
脲	hziuor
缬	xneoiu
纛	xviuee
痿	lcuoee
坩	ldeiie
圪	lvuuuu
嘧	kvruro
麸	xneeor
隈	ygeuor
锱	vwiuei
蠃	ybiuei
蛉	bqorru
蓖	fzoree
糅	qheior
柙	taiuee
昴	wpouou
慝	vfeoru
嬛	mceiue
鲱	dzieee
锨	vqouor
趺	zjeeor
荜	fmeiii
艏	paoiue
箜	ldeiee
狺	psreee
燠	pzroei
汊	nfrrrr
戗	dgeuor
坻	lmrrrr
圮	lgueuu
儋	jhorre
龋	hjiuei
龃	hbiuee
飧	bporru
郯	ppuiii
詈	csreee
缯	xwroiu
缗	xqiuee
筇	lluiii
瓤	bheeii
溷	nkeouo
涞	nwiorr
堀	lzuiiu
龅	hkueuu
骶	mmrrrr
锴	vmoiue
醐	tvouee
蘖	fjiueu
篌	ljueoe
玕	sneeii
焯	pliuee
枳	tkorrr
昝	nliuee
悱	hzieee
岿	ynueee
嗐	kveeei
龉	hjiuee
莪	fwoeie
绂	xdurrr
笥	lteiue
祐	hdiuee
硌	dzouri
砝	dweieu
燔	pmiuei
湜	nsiuee
洌	nbiiii
戆	mpoure
徭	fyoeei
哌	kaouor
偾	jpeiii
伛	jmeoru
髂	mvouri
隳	ydeieo
铩	vheior
荇	ffeeii
篪	laieuo
眄	bkuuuu
炆	pnreor
棻	fseior
栲	tfeuuu
暾	wguieo
黢	xcorou
鳉	dzoure
铋	vloooo
裎	hkeeie
莳	fweirr
芨	fsourr
窨	dmrero
瘿	ldiuor
渑	nkiuee
氦	vhreuo
橛	taroeu
樗	tpeeuu
怙	hveiiu
侑	jdiuee
蹚	zceiee
趿	zsourr
蝣	bduiee
苴	fbiuee
脔	plorrr
纮	xdurrr
麂	maouuu
鲀	dbeuiu
镝	vhiuei
轱	yveiiu
觜	thouou
螅	bjrurr
芗	fpoooo
矽	dbourr
矸	dneeii
瞵	bqoure
疖	lwuiii
玢	ssoruo
愀	hcroor
髡	bjouuu
镒	vaoriu
貔	dzoree
褫	haieuo
缣	xyroeu
筲	lciuee
椋	tlreiu
撄	gdiuor
崃	ywiorr
傈	jteior
黼	jqeiue
陉	ypurei
铱	vjreou
醢	tdiuei
蹓	zpiuei
蓊	fcureu
翥	fyureu
秭	cxroue
疴	lgeiue
槲	thrrei
曩	wbiuei
嘞	kquooo
陬	yyurrr
趸	wkieor
绀	xdeiie
稞	cweior
砑	daeuio
檠	dkoeor
槃	pdeior
桷	thouou
嵴	ynoriu
崮	ykeiiu
嬖	bmuoee
喆	nneiei
雩	pyuuuu
钼	vbiuee
醯	txoiui
胝	hmrrrr
盍	wciuii
璟	swreiu
溘	nwiuii
枥	tauooo
屌	zkiuii
嬗	mbiuiu
垌	lseiue
坭	lzouuu
哙	kdeeur
倥	jdeiee
髁	mweior
酹	tyeirr
郏	wduiii
贶	dkouuu
芫	flouuu
罍	ggiuei
絷	dduuri
絜	xsuuri
穑	cproei
祇	hmoueu
碚	dhiuee
瘗	lworei
琚	szeiiu
珙	speiie
枋	tmreuo
帑	cyiuii
鳜	daroeu
飏	ahuooo
酲	tkeeie
觚	hyoour
砬	dhrero
皤	dmiuei
犴	pneeii
澍	naeirr
歃	ntouor
楝	tzrooo
摭	gdrrrr
尻	zgouuu
鲽	ddueio
鬯	hnuiou
雎	bmoire
貅	djeior
裥	hfiuee
蝾	bweior
葑	fheirr
箪	lhroiu
笤	lsiuee
窣	dboror
皴	cfouru
毳	wwoeeu
廛	agorei
鬲	leiuei
髫	bsiuee
逑	wrrurr
蹀	zdueio
诜	sgoeie
謇	hsreee
蠖	bfoire
蝽	bliuee
蚬	bfiuou
腚	hprrue
沔	nkuuuu
塬	laoiue
黥	xlreiu
麇	mcoeio
鲙	ddeeur
蚴	bpuooo
缫	xwiuee
癔	lmrurr
溲	ntiurr
刳	kyuiii
鳎	dwureu
鲭	dheeie
髀	mdoiue
颡	ffeior
锒	vjueeu
觇	tfiuou
蘼	fyieee
茭	fqorrr
肄	nvueee
禊	hxuoeo
炝	pduuuu
棰	tzoeie
旒	dxoiuu
垡	jkeiee
喹	kkeiee
匏	kyuouu
鼐	wbueoi
鹪	mnouru
鲧	djuuri
髌	mvoiei
骀	aciuee
颙	wleoiu
鞫	qkreee
菹	ybiuee
苡	fburor
芰	fpurrr
祆	hfoeor
硖	dworrr
獬	phuooe
柽	tfeiee
厍	ayeuei
鲵	dtouuu
觌	ptrreo
螈	baoiue
蒡	fhreuo
芡	faouor
胼	haeoii
糁	qcoooo
瘙	lfriue
畚	cgiuei
泺	npiorr
棼	msoruo
杌	tjouuu
曛	wniuro
捽	gboror
幪	yweeou
巯	pxoiuu
妁	mkrrrr
堠	ljueoe
埒	lyeirr
鲆	dheroe
谮	sneuou
褰	hjreou
裰	hfurur
葸	fgrurr
萜	fyieiu
罟	cveiiu
瓴	qjeuur
湲	nyeeou
榧	tvieee
桴	tyuiee
吖	kwiiii
鳢	daeiue
骘	yhioou
馑	pyeiie
镏	vpiuei
跂	zpurrr
谰	sfeiue
蓐	fyeirr
茆	fpouou
艽	fgouuu
砻	ldeoiu
湓	nsiuii
椹	tguuuu
柝	tqrrrr
暌	wyeeor
峄	yfeeii
岈	yaeuio
劬	kkuooo
饩	pvoeeu
饧	ptoooo
鞯	qfeoiu
镉	vleiue
锕	vyeiue
醅	thiuee
酽	tsoooo
鄣	mpuiii
轫	ysrrrr
踣	zhiuee
跣	zgoeie
虿	wbiuei
蒹	fyroeu
芟	fdouur
芎	fxueuu
舁	tneoii
粳	qbeiue
筌	ldeeie
禛	hhorrr
毽	wsurrr
怍	hzoeie
孥	csuiee
妣	mmeuou
埝	lqrurr
刖	hniiii
鲳	dwiuee
饫	pfoeor
赜	qxiuor
舻	plueoo
膦	hqoure
罘	cheoir
磻	dmiuei
痧	lnioro
燊	pproor
氩	vseiir
榇	theior
捩	gteorr
埕	lkeeie
圯	lgueuu
鲉	daiuei
鲂	dmreuo
阏	fmorrr
铖	vkuuuu
钚	vheoir
辏	yleeor
蟊	hbiuei
藨	fmrrrr
蒴	fsouee
莨	fjueeu
苾	floooo
硚	dfoiii
眚	gbiuee
狍	pkueuu
煸	ptiuei
溏	naueei
湔	naroei
殂	bbiuee
摽	gteeio
埽	lcruiu
垴	lqreor
嘏	vqueie
呣	kvuure
骎	acruur
铍	vzuoiu
铊	vvouuu
酐	tneeii
蛄	bveiiu
缑	xjueoe
縠	bjuuri
籴	dqroei
笪	lqiuee
窅	dbiuee
玠	sdoiii
旻	wnreor
拶	gwourr
悛	hcorou
怿	hfeeii
嵊	ycieeo
佤	jjeuur
黾	kwuuuu
馕	pbiuei
郃	cyuiii
遘	pseier
辋	ysroer
蜊	bciiii
蔌	fzouor
荛	fpeuoe
翛	jnureu
缒	xjiueu
绐	xciuee
糨	qxiuei
祧	hxreor
瑱	shorrr
狨	pkeooo
炅	wproor
洹	njiuee
愦	hliuor
悫	barurr
屙	zyeiue
媵	hluoee
妫	mjourr
埙	lkiuor
叻	kwuooo
鸮	kwouru
鲢	dyrurr
隰	ywuurr
阼	yzoeie
阋	ftouuu
逄	njrurr
诔	sdeeei
蛳	bneiui
菘	ftorur
缶	yoeeiu
祓	hdurrr
碁	gdeoiu
砼	ddeiee
睃	bcorou
甙	kdeiie
猁	pciiii
狴	pmeiee
犇	ccoeei
炘	pqooei
浥	nkuieu
椤	tcourr
柁	tvouuu
崤	yheoiu
崄	yqrroe
娈	pmuoee
圹	lareoo
嘌	kteeio
勰	wwuoiu
偬	jjrrur
鸹	nfouru
铌	vzouuu
郫	dyuiii
轺	ysiuee
裣	hqrroe
茀	fxoiii
苌	fboeur
舨	paurrr
箨	lguree
窭	dquoee
桄	thiroe
昃	waorrr
戡	gpeuor
廨	ahuooe
妗	mqorru
垱	lcueee
囷	kcoeio
侉	jkeeuu
黻	jqeour
鹢	afiuii
陔	yhreuo
鏊	kvoree
酤	tveiiu
貊	djoiue
蚺	bseiee
薤	fbieee
荽	fyuoee
胙	hzoeie
纻	xveeee
粝	qaeuoo
簋	lhiuii
矇	bweeou
畋	gnoeor
甍	wqeuur
燋	pmrrrr
熳	pwiuii
烝	cnerrr
楦	tveiue
椟	tpurre
揎	gveiue
庥	ajeior
岍	yneeoi
媸	myeiue
凇	wtorur
僳	jtroei
侔	jcoeei
醑	tmiuee
邴	fduiii
遄	yyrurr
衒	fbuure
蜩	bseiei
葚	fguuuu
羼	zkroee
纩	xareoo
秫	ctrrrr
秕	cmeuou
瘌	lziiii
潆	nwuuri
氘	vnoiii
摅	gdrurr
佺	jdeeie
亶	bxiuee
鲊	dzoeie
镪	vxiuee
鄯	kaiueu
踔	zliuee
赪	cliuor
觳	bjouou
褙	hziuee
螽	nwiuei
蓥	wvoree
肼	hyeeoi
聱	kyeiie
耨	dyeirr
绠	xbeiue
绖	xgeure
瞀	hniuee
癜	lzeiie
痱	lzieee
畤	gleirr
猞	pqeiiu
溽	nyeirr
溆	nqeior
毖	mloooo
栳	tfouuu
捭	gdoiue
悃	hkeior
彿	fxoiii
堙	lteiee
喈	kmoiue
俜	jaeuuu
鹩	kwiuee
髑	mcouiu
骟	atureu
铗	vworrr
鋈	nforee
醌	tweuou
蚍	bmeuou
薅	fmeoee
萁	fgeiie
芄	fgrrrr
胍	hyoour
绁	xduuuu
笕	lfiuou
瞋	bhorrr
滹	ndoroe
浬	ngiuee
泚	ntieie
戽	tweiii
愔	hmrero
嫠	dneouo
卺	cneuuu
麹	xnouro
鹣	yfouru
鲅	ddurrr
鞬	qsurrr
躞	zsroor
躔	zaiuee
躐	zwiueu
豨	hheoiu
诖	sheiee
蟥	bpiuei
蓂	wwreor
脘	hveeou
缵	xgoeie
籼	qyiuii
硭	dfreuu
皲	qyuoiu
瘰	lguuri
澌	ngooei
漭	nfeorr
洎	njoiue
殍	byuiee
槠	tseieo
彖	ahouoo
堃	mmeiee
囝	ksuiee
嚭	akeoir
刬	kniiii
僦	jleour
鲮	dlorou
阇	ffeieo
郇	kwuiii
谝	stiuei
詟	lsreee
襻	htoror
裒	btouor
粜	ysroei
籥	lciuei
籀	lgouru
笮	lzoeie
熘	ppiuei
焐	pjiuee
濞	njiuei
濉	nboire
枧	tfiuou
晡	wfeiue
崦	ykiuee
埗	lhiooo
坌	sleiee
飐	ahieiu
靺	qdeeio
谠	scouuu
袢	hjroee
蝥	hniuei
蝓	bqiuee
茑	ffouru
茌	pleiee
脶	hkiuor
笾	lwrurr
瞢	wbiuee
燹	hhroor
殳	douurr
挢	gfoiii
扆	tjreou
慊	hyroeu
悰	hveeio
埴	lheiiu
嗞	kauuru
冇	dsiuuu
鹾	lkorro
鹁	bsouru
隹	moiree
闿	fyueuu
钍	vleiee
酎	tjeirr
跬	zheiee
谳	spiuro
蝰	bkeiee
蛞	bnoeii
蚶	bdeiie
舣	pnrorr
缧	xguuri
畀	giueie
璩	sdeouo
牤	cxreuu
潴	npeieo
梃	tsurrr
朐	hkiuee
旰	wneeii
擿	ghiuor
忮	hpurrr
崁	ylouor
尪	xseeie
宄	vgouuu
埸	lwouoo
埏	ljieuu
儇	jceiue
髹	bjeior
饔	bpooir
镢	varoeu
钽	vqiuee
酞	tkrrrr
郛	ysuiii
赆	dkrrrr
豳	yheouo
衄	jcuiee
舳	paiuei
舡	pleiee
肫	hbeuiu
羰	kyeoro
罽	caroor
祼	hweior
矬	vfeiee
癃	lyouro
畛	gdoooo
畎	gpeorr
焓	pqiuee
泖	npouou
抃	gjeirr
庹	dkueor
崟	yvoree
峁	ypouou
囟	zheeee
哏	khueeu
鲔	ddiuee
鲎	ndouiu
鲋	djeirr
鞳	qforei
锶	vgrurr
邽	hyuiii
邠	syuiii
蒌	fquoee
莸	fpeouu
罨	ckiuee
缊	xwiuii
糸	duurio
簏	lmreou
笫	lxroue
涴	nvouru
浼	nwouuu
浯	njiuee
浠	nheoiu
洇	nqiueo
泔	ndeiie
桤	tyueuu
曈	whiuee
嵚	yvouor
哕	kyourr
亹	btiuei
亍	aeeiii
丌	jeoiii
鲥	dweirr
驵	abiuee
馓	ppiuee
鞴	qpooue
鞮	qsiuee
锍	vxoiuu
逭	vhrurr
袷	hcorei
蟮	bkroei
舾	pteiuo
耧	dquoee
缌	xgrurr
绋	xxoiii
筚	lmeiii
窸	dmrurr
磙	dqurou
璺	tseiue
澶	nbiuiu
溦	nyeouo
洿	nkeeuu
沢	nkueor
氪	vvouuu
栝	tnoeii
枘	tliuor
旸	wtoooo
幞	yjroee
岜	yguieu
咴	kdroor
倮	jweior
鸲	kkouru
霅	psreee
锞	vweior
铯	vduieu
轹	ypiorr
贳	dpiuor
豇	hleiee
蜣	bkuuuu
蔟	fdoeeo
蓠	fqiuur
艿	fwuooo
肟	hyuuuu
绨	xxroue
祲	hcruur
祎	hjeeui
瞭	bkroiu
瘆	lcoooo
疳	ldeiie
疔	laeiii
瓿	hkeuur
璘	sqoure
潾	nqoure
泐	nyuooo
沚	nhieie
欸	cvouor
檑	tpiuei
樘	tceiee
楯	taeiiu
椠	yqeior
枵	tkeuuu
擐	gceiue
垚	lleiee
唣	kdeuuu
卬	pwuiii
亸	gsroiu
鳊	dtiuei
鍪	hnoree
醵	tdeouo
郾	vwuoeu
蹁	ztiuei
觏	pseiei
襕	hfeiue
袪	hweieu
菉	fcireo
芾	fjiuii
胂	hwiiii
耜	dhiueu
缳	xlouor
篚	lvieee
禋	hteiee
硎	dneeoi
砉	xdeoiu
眊	bwoeeu
瘳	lyoroo
疬	lauooo
枨	tboeur
曌	whrruo
攮	gbiuei
惛	hmiuee
尥	xkrrrr
夐	dxiuee
嗾	kdoeeo
唛	kxourr
匦	vyouuu
刿	ybiiii
倕	jzoeie
俶	jlioru
黉	npiuei
鲡	dceiur
锝	vweeir
酺	tfeiue
酃	phiueu
赙	dfeirr
谖	syeeou
蜱	bdoiue
萆	fdoiue
莩	fyuiee
荸	fbuiee
苈	fauooo
艨	pweeou
翚	yqeuei
罾	cwroiu
砜	daorrr
皦	ddreuo
瘐	ltorrr
瓘	sfiuei
珺	sciuee
猓	pweior
潲	nciroi
洫	njiuii
沩	njourr
桫	tnioro
朊	hyouuu
憷	hmuieo
惝	hciuiu
嶒	ywroiu
埤	ldoiue
厣	apiuee
倬	jliuee
乂	horrrr
龢	chiuei
龁	hvuuuu
鼯	tjiuee
黟	xbourr
鹍	wmouru
鸰	qfouru
鲻	dwiuei
鲹	dcoooo
骍	anrero
鞲	qpiuei
鞨	qwouor
镦	vguieo
迕	vprurr
辀	ypoour
蹐	znoriu
跱	zleirr
跏	ztuoiu
趵	zkrrrr
诐	szuoiu
蛴	bnoiii
蕞	fweiie
菪	fveoiu
羝	kmrrrr
綮	tnuuri
磡	dguuoo
硗	dpeuoe
盦	qtiuii
皞	ddeore
瘼	lyeiii
瘵	lyeeio
獍	pmouuu
狳	pqeior
犰	pgouuu
沄	nmeeur
檩	tbiuiu
榱	tgeouo
栌	tlueoo
擗	gbueoi
掎	gkeiue
怃	hjeouu
忭	hjeirr
忉	hsuooo
庋	apurrr
壸	bseiir
咍	kciuee
僇	jyoroo
仉	jaouuu
䜣	sqooei
龀	hnouuu
鹆	fdiueo
魋	smoire
霪	pnorro
镘	vwiuii
醣	taueei
酾	tceiur
鄠	pyuuii
赑	ddiuor
谫	sauooo
谇	sboror
襜	hhorre
蠓	bweeou
蜞	bgeiie
虮	baouuu
蒽	fqrurr
苁	fforor
芴	fjouoo
艟	phiuee
笊	lyooir
窊	dyoour
窆	djrurr
碲	dhiuii
琇	scuooo
狃	pauiee
瀹	nqiuei
滉	nwiroe
浐	nheooo
榘	vkeuei
掊	ghiuee
恓	hteiuo
庳	adoiue
帱	yxeirr
屺	ygueuu
夼	kwoiii
垤	lgeure
噍	kmrrrr
嗉	kxuuri
呙	kliuor
吽	kcoeei
俣	jkeeor
仳	jmeuou
齁	jgouiu
鼗	xneiei
鹮	clouor
馘	ajeuor
颃	baeoiu
顸	nneoiu
阘	fwureu
镵	vweuou
镟	vduieo
镓	vveouo
酴	tqeior
蹅	ztiuee
趼	zneeoi
貘	dyeiii
诼	shrrrr
蚵	baiuee
蚰	baiuei
薷	fpeoiu
蒗	yjueeu
苘	fsiuee
舯	pviuei
缋	xliuor
绗	xfeeii
箅	lgiuei
窬	dqiuee
稃	cyuiee
甓	bjeuur
焜	pweuou
炻	pdeoiu
滏	nleeir
涑	nzeiue
浍	ndeeur
氽	dniuor
氙	vyiuii
楗	tsurrr
梼	txeirr
斝	hqrrei
撙	gdeirr
摛	gqiuur
抔	gheoir
崚	ylorou
嗌	kaoriu
喾	njoeie
唵	kkiuee
哜	knoiii
呒	kjeouu
傒	jyuure
仫	jjurrr
龆	hsiuee
鹇	ftouru
鳣	dbiuiu
鳔	dteeio
鲯	dgeiie
鞒	qfoiii
镮	vlouor
镧	vfeiue
镆	vyeiii
锸	vnoieu
跶	zkrurr
趑	mpreou
觫	hzeiue
蟛	baoooo
缡	xqiuur
糍	qauuru
簦	lyeiue
矻	dvuuuu
瘥	lkeiee
瘕	lqueie
烜	pjiuee
渰	nceoii
檫	tvourr
晢	mwiuee
敉	qnoeor
戥	wgeuor
忺	haouor
弇	cneoii
尢	xeouuu
姱	mkeeuu
厖	axooor
冱	wjuuee
龠	qhiuei
鲿	dcruee
饹	pzouri
飔	ahiuei
颟	fforor
铪	vcorei
钕	vmuoee
跫	lariue
诹	syurrr
裛	bkuieu
蠼	bbiuee
蜾	bweior
蛲	bpeuoe
虓	gdouuu
萑	fmoire
茇	fdurrr
腠	hleeor
糌	qniriu
箦	lxiuor
筅	lgoeie
砟	dzoeie
眭	bheiee
甪	jtouee
漶	nkiuei
洳	nmiuee
汆	dniuor
毐	lvuuoe
椓	thrrrr
枲	ckeior
昇	wjeoii
揸	gtiuee
恧	ylrurr
嶝	yyeiue
嵛	yqiuee
嵎	ywiuie
屄	zdrruo
婞	mlroee
坜	lauooo
剀	ygiiii
佾	jfiuee
魆	skeuuo
鄄	tluiii
逴	lweiru
逯	cnrurr
踦	zkeiue
赇	dweire
谂	sqrurr
裼	hwouoo
裈	hqeuei
蛏	bfeiee
蒨	pheeie
菔	fhuiur
粢	pqroei
硙	dyueuu
瘅	lhroiu
璠	smiuei
牾	cjiuee
烀	pboroe
炱	ckroor
瀼	nbiuei
潏	nhiuor
渟	ngeiii
氚	vwoiii
恝	xsrurr
孓	cjrrrr
嬲	gwuoeu
圬	lyuuuu
嚚	hqiuei
劓	jgiiii
刭	pniiii
冏	sfiuee
鹖	wkoruo
鸺	jtouru
鳀	dsiuee
鲬	dturiu
鲦	dneior
骒	aweior
隩	yzroei
锔	vzuiue
铈	vbiuii
钇	vpuuuu
鋆	lkreor
郤	fdiueu
蟪	bjiuee
葜	fxuoeo
菝	fgeour
舲	pqorru
缲	xkiuei
笱	lkiuee
禘	hhiuii
碶	dxuoeo
矧	vxiiii
眵	bbourr
畬	qtiuei
璁	szoure
牂	kkroee
渖	nviuee
洧	ndiuee
氡	vnrrrr
榖	bcouur
椀	tvouru
柈	tjroee
柃	tqorru
昉	wmreuo
揲	gdueio
拃	gzoeie
戋	keeuor
廒	akeeie
墁	lwiuii
堋	lhouee
伲	jzouuu
鲼	dpeiii
骺	maeiue
驲	awiuee
饸	pcorei
陴	ydoiue
锼	vtiurr
锳	vfiueo
锩	vluuuu
铫	vxreor
钐	vwoooo
酂	ggiuor
郿	zbuiii
郐	dmuiii
跽	zgrurr
诇	ssiuee
觱	klouou
觋	lfiuou
蠛	bweouo
蝤	bdroei
虼	bvuuuu
蔸	fdoiue
茈	ftieie
艋	psiuii
臑	hpeoiu
胗	hdoooo
耑	yyeoiu
翾	clouor
缞	xgeouo
绹	xkoeei
縢	hluuri
糈	qmiuee
笸	lviuee
礅	dguieo
癀	lpiuei
痖	lseiir
玦	svorrr
熛	pteeio
煳	pvouee
滃	ncureu
汔	nvuuuu
氿	ngouuu
毹	qhiioe
殪	bbeiue
檎	tdreor
槚	ttiuor
桕	ttoieu
枒	taeuio
揠	gviuee
帨	ykouuu
巉	yweuou
嵝	yquoee
崿	yheeuu
岽	yyiorr
岨	ybiuee
尨	xwrrrr
嫪	myoroo
塄	lcreuo
坰	lsiuee
坫	ltieiu
啫	kfeieo
唼	khuoee
勍	lwuooo
劄	lciiii
麑	mtouuu
鹡	ndiuee
鸧	dgouru
鲰	dyurrr
鲐	dciuee
髟	beieee
靸	qsourr
钖	vtoooo
钌	vcuiii
醾	tyroei
轵	ykorrr
躜	zgoeie
跞	zpiorr
谞	smiuee
訚	fsreee
衎	fneeii
螗	baueei
蛸	bciuee
蒻	fxrere
芑	fgueuu
舴	pzoeie
脬	hyuiee
耪	dhreuo
簃	lcouro
筦	lveeou
硪	dwoeie
硁	dpurei
皛	ddoiue
瑨	ssiuee
爇	florei
熇	pgiuee
渫	ndueio
淠	ngiuei
浡	npruui
氾	nguuuu
氍	bboire
欻	ppouor
楙	theior
棐	zteior
杻	tauiee
搿	ncoeei
挦	gceirr
惙	hfurur
悝	hgiuee
廋	atiurr
巇	ydeiue
嵫	yauuru
崒	yboror
峣	ypeuoe
岢	ygeiue
嬅	mfeeii
媞	msiuee
夬	vdorrr
埘	lweirr
埆	lhouou
垧	lziuee
哢	kseoii
僬	jmrrrr
俵	jxouor
黹	jqroiu
鳇	ddeeie
鬘	bwiuii
髎	myoroo
馌	pwiuii
飑	ahouue
颎	npeoiu
阌	fyurrr
镡	vtiuee
镙	vguuri
铼	vwiorr
钬	vproor
醭	tjroee
醨	tqiuur
鄜	myuiii
迮	zrrurr
螬	bjiuei
蜎	bkiuee
蔀	fhiueu
蒉	fliuor
萩	fcroor
荭	fxeiee
荄	fhreuo
臁	haroeu
脒	hqroei
胨	hyiorr
肜	hwoooo
翃	dcureu
绲	xweuou
糵	fjiueu
簕	lquooo
穸	dbourr
穟	cweouo
稂	cjueeu
瞍	btiurr
癍	lsreor
畯	gcorou
甏	aweuur
珧	sxreor
濩	nfoire
溱	nloeio
淏	nweeor
洸	nhiroe
洑	njeorr
沨	naorrr
橦	thiuee
槔	tdeore
棨	tneior
棓	thiuee
杙	tkeurr
昺	wforrr
搒	ghreuo
掞	gproor
捃	gciuee
憝	gsoeor
庀	anouuu
岣	ykiuee
屼	yjouuu
垲	lyueuu
黪	xcoooo
鹋	fgouru
鸸	yfouru
鳓	dquooo
鳑	dhreuo
鲣	dmeiee
鲗	ddiiii
鲏	dzuoiu
髽	bfeiee
飗	ahouru
靿	qpuooo
雱	pmreuo
阽	ytieiu
镋	vcouuu
锽	vdeeie
锇	vwoeie
铏	vneeoi
跐	ztieie
赟	njeiei
謦	lzouur
襚	hweouo
蛑	bcoeei
藟	fgiuei
蔹	fqrroe
蒐	fsoiue
莰	flouor
莛	fsurrr
荬	ftrreo
芈	jjieee
芃	farrrr
艚	pjiuei
腯	haeiiu
腧	hqiuee
脞	hfeiee
肭	hliuor
翀	yviuei
缍	xzoeie
缂	xqeiie
粿	qweior
簠	lfiuii
篥	lteior
秬	cvueee
碥	dtiuei
睎	bheoiu
眢	bgiuee
瑳	skeiee
瑑	saouoo
狁	pcouuu
烺	pjueeu
澥	nhuooe
潟	ntourr
滪	nheoiu
滆	nleiue
溞	nfriue
浈	nliuor
泶	nniuor
枹	tkueuu
暵	wdiueo
弢	xyurrr
尜	ckiorr
嫜	mmeiii
奓	kbourr
墐	lyeiie
剟	ffiiii
剞	kgiiii
佧	jlirrr
伈	jlrurr
龂	hquioo
鼷	tyuure
鹴	pvouru
鹨	ydoooo
鹔	snorou
鞡	qgrero
鞔	qwouuu
闶	fbouuu
镴	vwiueu
镈	vfeirr
锾	vyeeou
锛	vkeieo
铷	vmiuee
辌	ylreiu
踶	zsiuee
赗	dwiuee
赒	dseiei
谿	ypeoro
褕	hqiuee
袆	hjeeui
蠋	bcouiu
螣	hliuei
蝻	bpiuro
蕰	ywiuii
蒱	fgeiue
蒎	yaouor
茚	fpeuii
舠	psuooo
肸	hfeiii
聍	yveiii
耵	yaeiii
糇	qjueoe
粞	qteiuo
礌	dpiuei
碹	dveiue
硇	dzoree
砩	dxoiii
瘃	lhrrrr
疢	lproor
瓞	yjeeor
璆	syoroo
瑢	sdoriu
琯	sviueu
琭	scireo
琤	sbouue
獯	pniuro
猰	pxuoeo
狝	paouio
爝	pyiuii
爚	pciuei
烔	pseiue
橑	tkroiu
椐	tzeiiu
朳	tforrr
憺	hhorre
惔	hproor
怊	hsiuee
忳	hbeuiu
彳	fooiii
廑	ayeiie
岵	yveiiu
孅	mfeuor
嫽	mkroiu
墼	ysouur
圊	kheeie
嗍	ksouee
叆	myeour
儳	jweuou
偲	jgrurr
乇	jneuuu
黡	apiuro
鳂	dgeuor
鲞	ldouiu
鲕	dyeoiu
鬏	bcroor
骱	mdoiii
颥	pyeoiu
韨	jdurrr
雊	kkoire
隃	yqiuee
镠	vyoroo
锓	vcruur
铟	vqiueo
铘	vauiii
铒	vyeiie
酏	tduiuu
辁	ydeeie
蹯	zmiuei
讻	shuiii
觿	hyoire
觖	hvorrr
袼	hzouri
螋	btiurr
蕺	fkeiie
蓢	fjueeu
莶	fqrroe
茺	fxouuu
茝	fqeiiu
苤	fheeee
芤	fsuuuu
芏	fleiee
艎	pdeeie
腘	hkeeie
胲	hhreuo
胬	clorrr
胠	hweieu
肷	haouor
耰	ddiuee
耇	fkiuee
羕	kjuuor
绱	xciuiu
纴	xsoeie
糒	qpooue
簰	lkoiue
簉	ljrurr
篼	ldouou
筥	lkiuee
稆	ckiuee
祃	hauuee
碡	dxuure
矰	vwroiu
瘛	lxuoru
疐	bguieo
甦	bgoeei
玃	pbiuee
瀵	nqiuei
澴	nceiue
滠	nyurur
湉	nhoeii
涘	ncoeeo
殣	byeiie
椑	tdoiue
棬	tluuuu
杩	tauuee
昽	wleouo
敫	dmoeor
慆	hyoieu
彟	cjeiiu
崾	ytuoee
岠	yvueee
嫘	mguuri
墦	lmiuei
埼	lkeiue
埵	lzoeie
坬	lyoour
噀	kgueue
嘚	kfiuee
唪	kleeii
叇	mcireo
卣	lkueee
劂	asouor
冁	hzeiie
伋	jsourr
仂	jwuooo
鹯	bxiuee
鹙	cpouru
鳙	daueei
鲴	dkeiiu
鲌	ddoiue
馉	pmiuur
馃	pweior
饳	pyuiii
陧	yweiee
陞	yjeoie
铚	vgeure
钭	vweiii
鄹	yfoioo
郈	aluiii
邶	zyuiii
遹	hsoriu
辒	ywiuii
蹜	zvoreo
趯	myoire
赕	dproor
裉	hhueeu
衠	fhoree
蟫	btiuee
蛘	bkroee
蔊	fpiuee
蓰	ffieie
葎	ffueee
茼	fseiue
茳	yleiee
舭	pmeuou
臜	hgoeie
缏	xjeiue
绤	xforiu
簖	lquooe
筻	lbeiue
窀	dbeuiu
璈	skeeie
珌	sloooo
燏	phiuor
焞	pguiee
澛	ndiuee
澉	nteiie
滫	njoeor
淜	nhouee
涠	nkeeui
洺	nbiuee
沲	nvuiuu
棁	tkouuu
柷	tkouuu
朏	hyuiii
晫	wliuee
昒	wjouoo
旐	dxreor
斠	pseier
敔	jkoeor
攉	gpoire
捯	ggiiii
慭	wneorr
惎	glrurr
悢	hjueeu
廾	neoiii
帡	yaeoii
嬿	mdiuer
塅	lgoiee
垞	lvoeuu
坶	lvuure
喤	kdeeie
哳	kmeieo
吣	klrurr
僰	qqorrr
偭	jheoiu
偓	jzeure
佽	jpreou
鼽	jgouuu
鼢	tsoruo
鹎	dfouru
鳠	dfoire
鳘	vvoeor
鲩	dveeou
鲚	dnoiii
鲒	dneiei
鲃	dguieu
鬒	bhorrr
鞁	qzuoiu
镃	vauuru
锧	vaeiiu
锊	vyeirr
铞	vkiuii
钪	vbouuu
钆	vpuuuu
銎	larore
鄫	wyuiii
邲	ljuiii
迺	trrurr
蹢	zhiuei
踺	zsurrr
讱	ssrrrr
蝘	bviuee
虒	adouuu
薢	nhuooe
蕻	fbeiie
蒟	fhouiu
菂	fdourr
芼	fwoeeu
膣	hdeure
腽	hwiuii
脿	hxouor
耔	dsuiee
翙	ybureu
羖	kdouur
罱	cpiuro
繄	vvouur
窎	dfouru
稌	cqeior
禔	hwiuee
祕	hloooo
祏	hdeoiu
磉	dfurur
砹	dforrr
砘	dbeuiu
砗	dyeuei
眍	bmeoru
皭	dyiuii
痦	ljiuee
疍	mqiuee
璪	skiuei
琲	szieee
琫	sleeii
玡	saeuio
玚	stoooo
玘	sgueuu
犨	mmoeei
牿	cjoeie
煴	pwiuii
焗	pzuiue
瀍	naiuee
滗	nloeeu
湑	nmiuee
浉	nneiui
洚	nneuii
汋	nkrrrr
槱	ttrrrr
榍	tziroi
棫	tkiuee
梿	tyrurr
柊	tnrrrr
晙	wcorou
昈	wtrueo
搛	gyroeu
掭	gfirrr
扊	tproor
忞	nlrurr
庼	aneoiu
岞	yzoeie
屃	zdiuor
孖	ssuiee
嫕	mvoeeo
嫄	maoiue
媭	wnuoee
婘	mluuuu
娵	myurrr
娀	mkeooo
姤	maeiue
姞	mneiei
奭	kjoiue
奡	dbeoro
堨	lwouor
堍	lwourr
咇	kloooo
勚	dpiuor
劢	wwuooo
冮	wleiee
傢	jveouo
偰	jxuoeo
倞	jlreiu
倓	jproor
麀	mnouuu
鹛	zbouru
鹒	acorou
鹀	lfouru
鸻	faouru
鸤	zfouru
鳒	dyroeu
鳈	ddiuor
鲾	dliuei
鲖	dseiue
鬷	lhuiur
髢	bduiuu
骕	asoior
骉	aauuee
骃	aqiueo
靰	qjouuu
镲	vvourr
镱	vmrurr
镩	vdiuei
镨	vaiiro
镚	vyouee
镅	vziuee
锬	vproor
锪	vjrurr
锎	vfeeoi
铑	vfouuu
钫	vmreuo
钔	vfriuu
鐾	bvoree
酦	txuour
鄗	gkuiii
踒	zcuoee
觭	hkeiue
袗	hdoooo
蟏	bfueei
蝲	bziiii
蘘	fbiuei
藠	fdoiue
薿	fnoeeo
蕹	fbuuoo
蕗	fzouri
蒇	fkiuor
萹	ftiuei
萚	fguree
菼	fproor
菥	ftooei
苠	fqueue
苊	fauuuu
艴	xnouui
腙	hveeio
腒	hzeiiu
耩	dpiuei
耥	dciuiu
耏	ywoooo
羑	ktourr
纼	xxiiii
箢	lvouru
筤	ljueeu
筢	lguieu
筀	lheiee
竫	hbouue
稙	cheiiu
稑	clorei
祊	hmreuo
礤	dfourr
礓	djiuei
磹	dtiuee
碨	dgeuor
碃	dheeie
砮	cdeoiu
矼	dleiee
盉	cciuii
瘊	ljueoe
疰	lkreei
甡	ggoeei
甗	dleuur
瑀	sjiuei
珽	sjeieu
玼	stieie
獴	pweeou
猺	pyoeei
猇	pdouuu
猃	pqrroe
狉	pheeee
牁	kgeiue
爟	pfiuei
焌	pcorou
澼	nbueoi
漼	nyoire
漻	nyoroo
漦	dneoiu
溻	nwureu
湴	naiiro
浞	nkieor
泜	nmrrrr
泙	nheroe
汧	nneeoi
氇	wdiuee
氆	waiiro
檵	tpuure
橥	pfeior
榰	tfouiu
榑	tfeirr
楩	tjeiue
棽	mqorru
梠	tkiuee
桹	tjueeu
桯	tkeeie
桊	lteior
杕	tkeorr
朓	hxreor
昳	wjeeor
昫	wkiuee
摴	gpeeuu
搌	gzeiie
揞	ghiuee
扅	tbourr
戤	wfiuii
憭	hkroiu
悆	qtrurr
弸	xhouee
弆	wneoii
嶲	ymiuii
嶓	ymiuei
嵁	yguuuu
崞	yguiee
崀	yjueeu
峘	yjiuee
宬	vkuuuu
婼	mfeoiu
婌	mlioru
妧	mleeou
堲	tweiee
堉	lxiuee
埯	lkiuee
埇	lturiu
圌	kyeoiu
囧	kfiuuu
嚄	kfoire
噂	kdeirr
啴	khroiu
哿	tgeiue
哱	kpruui
匼	vcorei
匜	vduiuu
勔	hwuooo
劼	nwuooo
儦	jmrrrr
傺	jyeeio
傉	jyeirr
偁	jyiuie
侘	jvoeuu
侂	jaoeuu
侁	jgoeie
佴	jyeiie
齇	jgieuo
齄	jgeior
鼫	tdeoiu
黇	paorie
鹠	pgouru
鹟	cyouru
鳛	dyoiue
鳋	dfriue
鳁	dwiuii
鲪	dciuee
鱽	dsuooo
骦	apeior
骣	azuieu
骙	ayeeor
馇	ptiuee
颋	sreoiu
靽	qjroee
靬	qneeii
隺	qmoire
阢	yjouuu
镥	vdiuee
镤	vjroee
镄	vxoiiu
锿	vgouor
锫	vhiuee
锘	vfeoiu
铻	vjiuee
铴	vnuooo
铕	vdiuee
钶	vaiuee
钘	vneeoi
钋	vlirrr
鄅	jkiuie
郪	jsuoeu
轪	ykeorr
谼	fdiuee
觟	hheiee
襫	hkeoiu
褟	hwureu
袯	hxuour
衃	gjiuii
螵	bteeio
螱	zseiri
螠	baoriu
蛃	bforrr
蚄	bmreuo
虸	bsuiee
藦	fyoeei
薳	fnoior
薁	fzroei
蔈	fteeio
蓏	fyoour
蓇	fmiuur
葰	pcorou
葙	fveior
葖	fdeorr
莙	fciuee
荖	ffouuu
荓	faeoii
芣	fheoir
艅	pqeior
胩	hlirrr
耱	dyeoiu
耤	dpiuee
翂	ysoruo
筘	lgiuee
笯	lmurrr
穜	chiuee
穄	cyeeio
礵	dpeior
礞	dweeou
磲	dneuue
磜	dyeeio
磏	dyroeu
碏	dpiuee
硿	ddeiee
硍	dhueeu
硊	dhuuuu
砫	dkreei
砆	djeeor
睄	bciuee
瘭	lteeio
瓻	hdiuie
瓖	sbiuei
璲	sweouo
琄	skiuee
珷	sjeiei
珫	sxouuu
珝	syureu
玱	sduuuu
玭	smeuou
玞	sjeeor
玙	sqeeee
犋	cborrr
牚	caeuio
煺	phrurr
煟	pgiuee
烻	pjieuu
炟	pqiuee
澂	nyeoeo
淴	njrurr
淟	naorrr
浰	nciiii
浕	nkrrrr
洴	naeoii
沺	ngiuei
汭	nliuor
欂	tyeiue
榀	tkiuei
楱	tleeor
椸	tduiuu
梽	tlrurr
梴	tjieuu
桲	tpruui
栻	tkeiee
栟	taeoii
晐	whreuo
旴	waeeii
敩	nsoeor
攽	snoeor
摏	gloieu
搋	gaieuo
揾	gwiuii
拤	glirrr
扺	gmoueu
憙	akrurr
幖	yteeio
嵲	yjeior
峿	yjiuee
峧	yqorrr
峗	yhuuuu
峃	nyiuii
岊	gyiuii
嬬	mpeoiu
嬥	myoire
嫭	mdoroe
媱	myoeei
媆	myeorr
媄	mkeorr
婳	mjiuei
姽	mhuuuu
墚	lnuoei
墈	lguuoo
塥	lleiue
塝	lhreuo
垕	aleiee
垍	ljoiue
嘡	kceiee
咺	kjiuee
咥	kgeure
咡	kyeiie
叚	queiee
劁	mniiii
剕	zniiii
凵	suiiii
凓	wteior
冔	wkeeii
儴	jbiuei
僎	jgueue
倴	jkeieo
倧	jveeio
俬	jcurrr
俙	jheoiu
俍	jjueeu
佖	jloooo
伾	jheeee
伭	jbuurr
丏	ktuuuu
齉	jgeiue
鼩	tkiuee
鼒	tbueoi
麖	mlreiu
鹱	ffoire
鹝	lfouru
鸼	pfouru
鳡	dkeiue
鳆	dviuee
鲺	dpoiue
鲝	kdouiu
鱾	dgueuu
髃	mwiuie
頔	adiuee
韂	qhorre
鞧	qdroei
霨	pzeeio
陑	yyeoiu
陎	yjeeio
镎	vcoeei
锖	vheeie
铽	vkrurr
铹	vwuooo
铥	vjeieu
钸	vdiuii
钷	vviuee
釐	dneoiu
酅	ymiuor
鄘	asiuee
鄑	swuiii
鄌	asiueu
鄃	qhiiui
鄀	fdiueu
郚	jkuiii
邘	ayuiii
遆	hyrurr
辿	yrrurr
轷	yboroe
軎	ykiuee
蹾	zguieo
蹽	zkroiu
貆	djiuee
豮	hpeiii
誌	slrurr
訄	gsreee
觍	afiuou
觃	fsuiee
褯	haeiie
袴	hkeeuu
蠧	bdiuei
蟓	bwouiu
蜐	bwuooo
蚆	bguieu
虤	daieuo
虍	dieuoe
薸	yteeio
蔃	fxiuei
蒈	fmoiue
萳	fpiuro
菍	fqrurr
莝	ffeiee
荮	fxeirr
荙	fkrurr
荁	fjiuee
茽	pviuei
茓	fdrruo
膪	hhiuii
膙	hxiuei
腨	hyeoiu
脟	hyeirr
脎	hheior
胈	hdurrr
耢	dwuooo
耠	dcorei
耖	dvioro
翷	qbeuiu
翈	ayureu
羱	kaoiue
羓	kguieu
罶	cpiuei
缐	xdiuor
簝	lkroiu
篯	lveeuo
箖	lmeior
筼	lkiuor
筶	ljoeie
筜	lcueee
竘	hkiuee
竑	hdurrr
禤	hcureu
禚	hkrrrr
祾	hlorou
祋	hdouur
砵	dteeee
砢	dgeiue
砠	dbiuee
砄	dvorrr
瞫	btiuee
盷	bkreee
皕	jdeoiu
癗	lpiuei
痓	lgeure
痄	lzoeie
痃	lbuurr
疭	lforor
疁	gyoroo
畖	gyoour
瓀	speoiu
璬	sdreuo
璥	sfouiu
璒	syeiue
瑬	nxoiue
瑝	sdeeie
瑖	sgoiee
瑔	sdiuor
瑆	swoeei
瑅	ssiuee
瑃	sliuee
瑂	sziuee
琡	slioru
琟	smoire
琔	sprrue
琎	syrurr
琍	sciiii
琀	sqiuee
珹	skuuuu
珸	sjiuee
珵	skeeie
珦	sziuee
珖	shiroe
珕	swuouo
珒	ssueee
珇	sbiuee
玿	ssiuee
玹	sbuurr
玶	sheroe
玓	skrrrr
玒	sleiee
猹	ptiuee
猸	pziuee
猯	pyeoiu
猄	plreiu
犏	ctiuei
牮	bcoeei
牥	cmreuo
爔	pkoeio
燚	pproor
熻	pcureu
熥	ptrurr
熜	pzoure
煃	pkeiee
煁	pguuuu
烶	psurrr
炣	pgeiue
炌	pdoiii
灈	nbiuee
瀱	nceoro
瀔	nbeouu
澭	nbuuoo
潽	naiiro
潵	npiuee
潖	nseeie
漹	nkeurr
漷	nguieu
漴	nyrrue
漈	nyeeio
滍	nyeiue
溵	naueeo
溠	nkeiee
溚	nforei
溍	nsiuee
溇	nquoee
湣	nqiuee
湝	nmoiue
渼	nkeorr
淯	nxiuee
涢	nkiuor
涐	nwoeie
涍	nfuiee
浲	nneeei
浭	nbeiue
浟	njoeor
浛	nqiuee
洭	nveeie
洨	nqorrr
洢	njueeo
洈	nhuuuu
泃	nkiuee
泂	nsiuee
沘	nmeuou
沇	ncouuu
汫	nyeeoi
汈	nteeee
氕	vjoooo
毑	vduiuu
毌	vuueii
歔	djouor
歅	tlouor
櫆	tsrrei
榅	twiuii
榃	mgiuei
楪	tdueio
椪	taiiro
梾	twiorr
梣	tyorru
梌	tqeior
栴	tviure
栐	tjuuor
柖	tsiuee
枍	tfeuuu
枅	tneeoi
杧	txreuu
暲	wmeiii
暕	wzrooo
暅	wheiue
晱	wproor
晊	wgeure
晅	wjiuee
昪	wceoii
昤	wqorru
昡	wbuurr
昄	waurrr
旿	wveiii
旵	wyiuii
斶	qcouiu
攴	lfurrr
撖	gteiie
揳	gxuoeo
挓	gvoeuu
扽	gbeuiu
扂	ttieiu
戭	vjiuei
憕	hyeiue
慬	hyeiie
慥	hjrurr
慓	hteeio
愭	hfouiu
悈	hkeoii
弶	xlreiu
弪	xpurei
廙	ageiie
廆	asoiue
庤	aleirr
嶦	yhorre
嶟	ydeirr
嶍	yyoiue
嶅	kyiuii
嵖	ytiuee
嵅	ykeiue
崡	ycreor
崌	yzeiiu
峱	paiuii
峂	ynrrrr
屾	yyiuii
宧	vqeiiu
媖	mfiueo
媓	mdeeie
媂	mhiuii
婻	mpiuro
婫	mweuou
婤	mseiei
婍	mkeiue
娭	mcoeeo
姶	mcorei
姈	mqorru
妭	mdurrr
妘	mmeeur
墣	ljroee
墘	lxeouu
堽	lceiei
堼	hjeiee
堧	lyeorr
堎	llorou
堌	lkeiiu
埪	ldeiee
埌	ljueeu
垵	lvuoee
垯	lkrurr
垙	lhiroe
垎	lzouri
坽	lqorru
坒	mleiee
坋	lsoruo
圲	lnoeii
圢	laeiii
圙	kfeoiu
圐	kcreuo
嚆	kfreiu
噇	khiuee
嘢	kgurui
唝	kliuor
哃	kseiue
呇	nkiuee
厾	pweieu
勠	ydooou
剋	vxiiii
剅	hniiii
凘	wgooei
僔	jdeirr
偡	jguuuu
倻	jyuiii
俫	jwiorr
侹	jsurrr
佸	jnoeii
佁	jciuee
伣	jfiuou
乸	dvuure
𬺓	hmuieo
𬺈	hkeiue
𬹼	hdoiii
𬸪	mgouru
𬸦	dmouru
𬸣	hfouru
𬸚	pseorr
𬸘	vwuoeo
𬷕	ffouru
𬶮	daiuee
𬶭	dyeeio
𬶨	tnouiu
𬶠	dzrooo
𬶟	dziiii
𬶐	dxreor
𬶏	dhuuuu
𬶍	dvouuu
𬶋	dkiuee
𬴊	aqoure
𬴃	axeoiu
𬴂	azieee
𬳿	aqeior
𬳽	agoeie
𬳶	asiuee
𬳵	aheeee
𬱟	hgeoiu
𬱖	aneoiu
𬯎	yliuor
𬯀	ynoiii
𬮿	yyueuu
𬮱	fteiee
𬭼	vweouo
𬭸	vqoure
𬭶	vxiuro
𬭳	vaiuee
𬭯	vqoeor
𬭬	vxeeei
𬭩	vcureu
𬭤	vjueoe
𬭛	vnuoiu
𬭚	vguiee
𬭎	vveour
𬭊	vteiee
𬭁	vvuure
𬬿	vsiuee
𬬻	vlueoo
𬬹	vwiiii
𬬸	vtrrrr
𬬱	vqooei
𬬮	vboeur
𬬭	vdouuu
𬬩	vkeurr
𬪩	tlruou
𬩽	cjuiii
𬨎	ydroei
𬨂	ymoueu
𬤝	sjiuee
𬤊	ssiuee
𬤇	steiee
𬣳	shueeu
𬣡	skeeuo
𬣞	sveeee
𬣙	saeeii
𬟽	byiorr
𬟁	flouru
𬞟	fhiooe
𬜯	fforor
𬜬	ffiuee
𬙋	xbiuei
𬙊	xxeiee
𬙂	xveiue
𬘯	xguiee
𬘭	xmeior
𬘬	xheeie
𬘫	xveeou
𬘩	xjeieu
𬘡	xqiueo
𬘘	xqouuu
𬘓	xwoiii
𬕂	lliuor
𬒗	dliuou
𬒔	dhiuee
𬒈	ndeoiu
𬍤	sceirr
𬍡	ntooee
𬍛	spiorr
𬌗	acorei
𬊤	phroiu
𬊈	pceirr
𬉼	pmeoru
𬇹	nkeeie
𬇙	ndiuor
𬇕	nweuoo
𬃊	taeiiu
𬂩	tworrr
𬀪	wfiuou
𬀩	wjeeui
𫸩	xmeoru
𫷷	avouor
𫶇	yfruiu
𫵷	yaeuoo
𫰛	mpurei
𫮃	lhroiu
𫭼	lwuooo
𫭢	ldouuu
𫭟	lmeoru
𫫇	ksrurr
𫢸	jhroiu
𫠜	htouuu
𫠊	abuurr
𫠆	pfeoiu
𫟼	vkrurr
𫟹	vpeiie
𫟦	yweouo
𫟅	xlreiu
𫞩	sfeiuo
𫛭	psouru
𫚭	dwiueu
𫚖	tdouiu
𫚕	dneiui
𫘬	ayuure
𫘪	aaoiue
𫘨	asiuee
𫘧	acireo
𫘦	akoeei
𫘝	avorrr
𫘜	anreor
𫗴	pbiuiu
𫗧	pzeiue
𫖳	ckeoiu
𫖯	xneoiu
𫖮	ygeoiu
𫔶	fjeior
𫔎	vhiuor
𫔍	vmiuei
𫓹	vgeiie
𫓶	vkiuee
𫓯	vheiee
𫓧	vjeeor
𫑡	kwuuii
𫐓	yheior
𫐐	ytouuu
𫐄	yjouuu
𫍽	sceiue
𫍲	stiurr
𫍯	skeiue
𫍣	sseiue
𫌀	hxiuor
𫇭	fjourr
𫄸	xniuro
𫄷	xmrurr
𫄨	xheoiu
𪾢	bfiuou
𪩘	ypiuro
𪨶	ykeuei
𪨰	yaiuei
𪤗	lyoroo
𪣻	lquoee
𪟝	xduooo
𩾌	daueei
𩾃	dwouuu
𩽾	dvuoee
𨺙	ytouuu
𨱔	vdeirr
𨱑	vpiuei
𨱏	vforei
𨱇	vweire
𨭉	njeiei
𨟠	bboire
𨚕	cnuiii
𨙸	pfuiii
𨐈	yhiroe
𧿹	zvuure
𦰡	fsuiii
𦭜	fkorrr
𦝼	hquoee
𦙶	hveiiu
𦒍	hgureu
𦈡	xpeoiu
𥻗	qtiuee
𥖨	dkiuei
𥕢	djiuei
𥔲	dheeuu
𤫉	ssroor
𤩽	spiuro
𤧛	shiuii
𣸣	npeiii
𣲘	njeouu
𣲗	njeeui
𣗋	tcouuu
𡐓	laueei
𡎚	ltiuei
𠳐	kxuiii
𠙶	csuiii
𠅤	bgrurr
鿏	vxourr
鿎	dkrurr
鿍	lneuii
鼱	theeie
鹲	wjeouo
鹐	dtouru
鳤	dlrrui
鲘	daeiue
鬶	jfeiue
馧	cwiuee
馞	cweiru
馝	cwruro
饻	pjreou
鄚	yyuiii
邿	ljuiii
逎	trrurr
蚲	bheroe
虷	bneeii
蒄	wleirr
葴	fkeiue
萣	fprrue
莿	fqiiii
茋	fmrrrr
苧	fveiii
苉	fvouuu
舥	pguieu
胣	hvuiuu
翯	ygiuee
粬	qaiuei
穙	cjroee
禒	haouoo
碈	dmiuee
硔	dpeiie
癿	dpuuuu
璱	sseeie
璮	sbiuiu
瑧	sloeio
瑓	szrooo
琈	syuiee
珢	shueeu
珛	sdiuee
珋	spouou
玤	sxeeei
牻	cxooor
煓	pyeoiu
煋	pwoeei
焆	pkiuee
烠	pdiuee
瀌	nmrrrr
濋	nmuieo
澽	ndeouo
澪	nporru
潩	ngeiie
漤	nmuoee
漖	nfuieo
漋	nyouro
滧	nqoroe
溹	nbuuri
溁	nweior
涄	naeuuu
洣	nqroei
洘	nfeuuu
洓	nqeiui
泇	ntuoiu
毪	wcoeei
檞	thuooe
橞	tjiuee
槜	tmuooo
楒	tgrurr
椆	tseiei
棪	tproor
棤	tpiuee
栒	tkiuee
杄	tnoeii
朸	twuooo
暿	waiuee
暶	wduieo
晪	waorrr
昣	wdoooo
旞	dweouo
揕	gguuuu
戣	yfeuor
愐	hheoiu
愃	hveiue
恔	hqorrr
徛	fkeiue
彐	cueeee
弨	xsiuee
庱	alorou
崶	yheirr
峛	ybiiii
峏	yyeoiu
寁	vjueei
墡	lkroei
墕	lkeurr
塱	jtouee
堾	lliuee
堐	laeiee
埫	lciuiu
垿	laurui
垾	lweeii
垺	lyuiee
垏	lsueee
垈	bleiee
坥	lbiuee
坉	lbeuiu
圫	ljeuuu
咉	kseorr
叕	ffurur
劐	fmurii
傃	jxuuri
侴	qaiiii
䶮	lfeeor
䴙	bfouru
䴘	adouou
䴗	wpouru
䴖	hfouru
䴕	bnouru
䴔	qhouru
䴓	jyouru
䲢	hlouiu
䲠	dliuee
䲟	dpeuii
䦃	vfeieo
䥽	vxuour
䣘	cluiii
䢼	pyuuii
䢺	ysuiii
䝙	dmeoru
䗴	bloeie
䗪	dniuei
䗛	bjouri
䗖	bfruiu
䕫	fdieie
䓬	fliuee
䓫	fkeiue
䓨	wyoeei
䓛	fzuiiu
䓖	fduooo
䐃	hkoeio
䏲	hxroue
䏡	hseeio
䏝	hyurrr
䎖	wyureu
䎃	slureu
䌹	xsiuee
䅟	ccoooo
䃎	dkouro
䃅	dhroiu
䂮	xseoiu
䁖	bquoee
㿠	dhiroe
㽏	nceiie
㻬	speeuu
㺄	pqiuee
㸌	ppoire
㸆	pjieee
㶲	ptouee
㵐	naroeu
㴔	nxrurr
㳚	nkrrrr
㳘	nxouuu
㳇	nloror
㰀	tcouoo
㮾	jtouee
㭕	tweieu
㭎	tsorrr
㬚	wxiuee
㬎	wpruur
㬊	wyeeou
㫰	wjueeu
㧟	gneuuu
㧑	gjourr
㧐	gfurur
㥄	hlorou
㤘	hxouue
㠓	yweeou
㠇	yleour
㟃	yteiue
㛹	mjeiue
㛚	mturiu
㛃	xsuoee
㙦	qtrrei
㙘	ltuoee
㙍	lfurur
㘎	kfueii
㕮	kloror
㑊	jpreoi
㑇	jxouue
𫄧	xjieuu
仈	jforrr
伻	jheroe
凃	wqeior
媢	mwiuee
鴘	cnoiue
暋	qniuee
蚡	bsoruo
穀	bjoeio
𮧵	jyeiii
鿔	vgeiue
鿭	vaouio
𫟷	vhrero
鿬	dgiuei
鿫	vzroei
囍	akeiei
牠	cduiuu
祂	hduiuu
奀	hkeorr
咁	kdeiie
呯	kheroe
喰	kporru
艹	feiiii
鶸	xwueur
