的	白勹丶丶丶丶
一	一一一一一一
是	是丨ㄋ一一一
不	不一丿丨丶丶
了	了ㄋ丨丨丨丨
在	土一丨一一
人	人丿丶丶丶丶
有	⺝丨ㄋ一一
我	我丿一丨一ㄋ
他	亻也ㄋ丨ㄋㄋ
这	文辶丶ㄋ丶丶
个	人丨丨丨丨丨
们	亻门丶丨ㄋㄋ
中	中丨ㄋ一丨丨
来	夹来丨丿丶丶
上	上丨一一一一
大	大一丿丶丶丶
为	丶力丶丶丶丶
和	禾口丨ㄋ一一
国	囗王丶丶丶丶
地	土也ㄋ丨ㄋㄋ
到	至刂丨丨丨丨
以	以ㄋ丶丿丶丶
说	讠𠮦丿ㄋㄋㄋ
时	日寸一丨丶丶
要	覀女ㄋ丿一一
就	京尢丶丶丶丶
出	屮凵ㄋ丨丨丨
会	人云一一ㄋ丶
可	可一丨ㄋ一丨
也	也ㄋ丨ㄋㄋㄋ
你	亻尔丿ㄋ丨丿
对	又寸一丨丶丶
生	生丿一一丨一
能	厶⺝丿ㄋㄋㄋ
而	而一丿丨ㄋ丨
子	子ㄋ丨一一一
那	阝ㄋ丨丨丨
得	彳旦一丨丶丶
于	于一一丨丨丨
着	目丨ㄋ一一
下	下一丨丶丶丶
自	自丿丨ㄋ一一
之	之丶ㄋ丶丶丶
年	一丨一丨
过	寸辶丶ㄋ丶丶
发	发ㄋ丿ㄋ丶丶
后	一丨ㄋ一
作	亻乍丿一丨一
里	里丨ㄋ一一丨
用	用丿ㄋ一一丨
道	䒑自丶ㄋ丶丶
行	彳亍一一丨丨
所	丿丿一丨
然	犬丶丶丶丶
家	宀豕一丿ㄋ丿
种	禾中丨ㄋ一丨
事	肀ㄋ一一丨
成	戊ㄋㄋㄋㄋ
方	方丶一ㄋ丿丿
多	夕夕丿ㄋ丶丶
经	纟轻ㄋ丶一丨
么	丿厶ㄋ丶丶丶
去	去一丨一ㄋ丶
法	氵去一丨一ㄋ
学	子ㄋ丨一一
如	女口丨ㄋ一一
都	者阝ㄋ丨丨丨
同	冂一丨ㄋ一
现	王见丿ㄋㄋㄋ
当	彐ㄋ一一一
没	氵殳丿ㄋㄋ丶
动	云力ㄋ丿丿丿
面	面一丿丨ㄋ丨
起	走己ㄋ一ㄋㄋ
看	目丨ㄋ一一
定	定丶丶ㄋ一丨
天	天一一丿丶丶
分	分丿丶ㄋ丿丿
还	不辶丶ㄋ丶丶
进	井辶丶ㄋ丶丶
好	女子ㄋ丨一一
小	小丨丿丶丶丶
部	立口ㄋ丨丨丨
其	其一丨丨一一
些	此二一一一一
主	主丶一一丨一
样	木羊丶丿一一
理	王里丨ㄋ一一
心	心丶ㄋ丶丶丶
她	女也ㄋ丨ㄋㄋ
本	木一一一一一
前	前丶丿一丨ㄋ
开	开一一丿丨丨
但	亻旦丨ㄋ一一
因	因丨ㄋ一丿丶
只	口八丿丶丶丶
从	从丿丶丿丶丶
想	相心丶ㄋ丶丶
实	宀⺀一丿丶丶
日	日丨ㄋ一一一
军	冖车一ㄋ一丨
者	者一丨一丿丨
意	音心丶ㄋ丶丶
无	一尢一丿ㄋㄋ
力	力ㄋ丿丿丿丿
它	宀匕丿ㄋㄋㄋ
与	与一一一一一
长	长丿一ㄋ丶丶
把	扌巴ㄋ丨一ㄋ
机	木几丿ㄋㄋㄋ
十	十一丨丨丨丨
民	民ㄋ一ㄋ一ㄋ
第	弓丨丿丿丿
公	公丿丶ㄋ丶丶
此	此丨一丨一丿
已	已ㄋ一ㄋㄋㄋ
工	工一丨一一一
使	亻丿丶丶丶
情	忄青一一丨一
明	日月丿ㄋ一一
性	忄生丿一一丨
知	矢口丨ㄋ一一
全	人王一一丨一
三	三一一一一一
又	又ㄋ丶丶丶丶
关	䒑大一丿丶丶
点	占灬丶丶丶丶
正	正一丨一丨一
业	业丨丨丶丿一
外	夕卜丨丶丶丶
将	丬夕一丨丶丶
两	丙从丿丶丿丶
高	口丨ㄋ一一
间	门日丨ㄋ一一
由	由丨ㄋ一丨一
问	门口丨ㄋ一一
很	彳艮ㄋ一一ㄋ
最	日耳ㄋ丶丶丶
重	千里丨ㄋ一一
并	䒑廾一丿丨丨
物	牜勿丿ㄋ丿丿
手	手丿一一丨丨
应	广丶丶丿一
战	占戈一ㄋ丿丶
向	口丨ㄋ一一
头	⺀大一丿丶丶
文	文丶一丿丶丶
体	亻木一一一一
政	正攵丿一丿丶
美	大一丿丶丶
相	相一丨丿丶丨
见	见丨ㄋ丿ㄋㄋ
被	衤皮ㄋ丿丨ㄋ
利	禾刂丨丨丨丨
什	亻十一丨丨丨
二	二一一一一一
等	土一丨丶丶
产	厂一丿丿丿
或	戈口一一一一
新	立朩丿丿一丨
己	己ㄋ一ㄋㄋㄋ
制	巾丨丨丨丨
身	身丿丨ㄋ一一
果	日木一丨丿丶
加	加ㄋ丿丨ㄋ一
西	西一丨ㄋ丿ㄋ
斯	其斤丿丿一丨
月	月丿ㄋ一一一
话	讠舌丿一丨丨
合	合丿丶一丨ㄋ
回	回丨ㄋ丨ㄋ一
特	牜土一丨丶丶
代	代丿丨一ㄋ丶
内	内丨ㄋ丿丶丶
信	亻言丶一一一
表	丿ㄋ丿丶
化	化丿丨丿ㄋㄋ
老	耂匕丿ㄋㄋㄋ
给	纟合丿丶一丨
世	廿乚ㄋㄋㄋㄋ
位	亻立丶一丶丿
次	次丶一丿ㄋ丿
度	度又ㄋ丶丶丶
门	门丶丨ㄋㄋㄋ
任	亻壬丿一丨一
常	巾丨ㄋ丨丨
先	先丿一丨一丿
海	氵ㄋㄋ丶一
通	甬辶丶ㄋ丶丶
教	耂子丿一丿丶
儿	儿丿ㄋㄋㄋㄋ
原	厂白丨丿丶丶
东	小丨丿丶丶
声	士ㄋ丨一丿
提	扌是丨ㄋ一一
立	立丶一丶丿一
及	及丿ㄋ丶丶丶
比	比一ㄋ丿ㄋㄋ
员	口贝丨ㄋ丿丶
解	角刀丿一一丨
水	水丨ㄋ丿丶丶
名	夕口丨ㄋ一一
真	直八丿丶丶丶
论	讠仑丿丶丿ㄋ
处	夂卜丨丶丶丶
走	走一丨一丨一
义	义丶丿丶丶丶
各	各丿ㄋ丶丨ㄋ
入	入丿丶丶丶丶
几	几丿ㄋㄋㄋㄋ
口	口丨ㄋ一一一
认	讠人丿丶丶丶
条	夂朩一丨丿丶
平	平一丶丿一丨
系	丿糸ㄋㄋ丶丨
气	气丿一一ㄋㄋ
题	是页一丿丨ㄋ
活	氵舌丿一丨丨
尔	尔丿ㄋ丨丿丶
更	更一丨ㄋ一一
别	口力丨丨丨丨
打	扌丁一丨丨丨
女	女ㄋ丿一一一
变	亦又ㄋ丶丶丶
四	口儿丿ㄋㄋㄋ
神	礻日丨丨丨丨
总	𠮦心丶ㄋ丶丶
何	亻可一丨ㄋ一
电	日乚ㄋㄋㄋㄋ
数	米女丿一丿丶
安	宀女ㄋ丿一一
少	少丨丿丶丿丿
报	扌卩ㄋ丶丶丶
才	才一丨丿丿丿
结	纟吉一丨一丨
反	又ㄋ丶丶丶
受	又ㄋ丶丶丶
目	目丨ㄋ一一一
太	大丶丶丶丶丶
量	旦里丨ㄋ一一
再	丙土一丨一一
感	戊丶ㄋ丶丶
建	聿廴ㄋ丶丶丶
务	夂力ㄋ丿丿丿
做	亻古丿一丿丶
接	扌立ㄋ丿一一
必	心丿丿丿丿丿
场	土㇡丿丿丿丿
件	亻牛丿一一丨
计	讠十一丨丨丨
管	宀丨ㄋ一ㄋ
期	其月丿ㄋ一一
市	亠巾丨ㄋ丨丨
直	直一丨丨ㄋ
德	彳十丨ㄋ丨丨
资	次贝丨ㄋ丿丶
命	亼口ㄋ丨丨丨
山	山丨ㄋ丨丨丨
金	金丿丶一一丨
指	扌匕丨ㄋ一一
克	古儿丿ㄋㄋㄋ
许	讠一丨丨丨
统	纟丿ㄋㄋㄋ
区	区一丿丶ㄋㄋ
保	亻呆丨ㄋ一一
至	至一ㄋ丶一丨
队	阝人丿丶丶丶
形	开彡丿丿丿丿
社	礻土一丨一一
便	亻更一丨ㄋ一
空	穴工一丨一一
决	冫丿丶丶丶
治	氵厶丨ㄋ一一
展	尸ㄋ丿丶丶
马	马ㄋㄋ一一一
科	禾⺀一丨丨丨
司	一丨ㄋ一
五	五一丨ㄋ一一
基	其土一丨一一
眼	目艮ㄋ一一ㄋ
书	丨丶丶丶
非	非丨一一一丨
则	贝刂丨丨丨丨
听	口斤丿丿一丨
白	白丿丨ㄋ一一
却	去卩ㄋ丨丨丨
界	田人丿丨丨丨
达	大辶丶ㄋ丶丶
光	光丨丶丿一丿
放	方攵丿一丿丶
强	弓口丨ㄋ一丨
即	卩ㄋ丨丨丨
像	亻象丿ㄋ丨ㄋ
难	又隹丿丨丶一
且	且丨ㄋ一一一
权	木又ㄋ丶丶丶
思	田心丶ㄋ丶丶
王	王一一丨一一
象	象丿ㄋ丨ㄋ一
完	宀元一一丿ㄋ
设	讠殳丿ㄋㄋ丶
式	弋工一丨一一
色	巴ㄋ丨一ㄋ
路	各丿ㄋ丶丨
记	讠己ㄋ一ㄋㄋ
南	十冂丶丿一一
品	口吅丨ㄋ一丨
住	亻主丶一一丨
告	告丿一丨一丨
类	米大一丿丶丶
求	求一丨丶一丿
据	扌尸一丨丨ㄋ
程	禾口一一丨一
北	北丨一一丿ㄋ
边	力辶丶ㄋ丶丶
死	歹匕丿ㄋㄋㄋ
张	弓长丿一ㄋ丶
该	讠亥丶一ㄋ丿
交	六乂丿丶丶丶
规	夫见丨ㄋ丿ㄋ
万	万一ㄋ丿丿丿
取	耳又ㄋ丶丶丶
拉	扌立丶一丶丿
格	木各丿ㄋ丶丨
望	亡月一一丨一
觉	见丨ㄋ丿ㄋ
术	木丶丶丶丶丶
领	令页一丿丨ㄋ
共	共一丨丨一
确	石角丿ㄋ丿ㄋ
传	亻二ㄋ丶丶丶
师	一丨ㄋ丨丨
观	又见丨ㄋ丿ㄋ
清	氵青一一丨一
今	今丿丶丶ㄋㄋ
切	七刀ㄋ丿丿丿
院	阝宀一一丿ㄋ
让	讠上丨一一一
识	讠口丿丶丶丶
候	丿一一丿
带	冖丨ㄋ丨丨
导	巳寸一丨丶丶
争	争丿ㄋㄋ一一
运	云辶丶ㄋ丶丶
笑	夭丿一丿丶
飞	丿丶丶丶
风	几乂丿丶丶丶
步	止丨丿丿丿
改	己攵丿一丿丶
收	丩攵丿一丿丶
根	木艮ㄋ一一ㄋ
干	干一一丨丨丨
造	告辶丶ㄋ丶丶
言	言丶一一一丨
联	耳䒑一丿丶丶
持	扌土一丨丶丶
组	纟且丨ㄋ一一
每	母ㄋㄋ丶一
济	氵文丿丨丨丨
车	车一ㄋ一丨丨
亲	立朩一丨丿丶
极	木及丿ㄋ丶丶
林	林一丨丿丶一
服	月卩ㄋ丶丶丶
快	忄丿丶丶丶
办	力八丿丶丶丶
议	讠义丶丿丶丶
往	彳主丶一一丨
元	元一一丿ㄋㄋ
英	艹冂一丿丶丶
士	士一丨一一一
证	讠正一丨一丨
近	斤辶丶ㄋ丶丶
失	丿夫一一丿丶
转	车二ㄋ丶丶丶
夫	夫一一丿丶丶
令	令丿丶丶ㄋ丶
准	冫隹丿丨丶一
布	巾丨ㄋ丨丨
始	女厶丨ㄋ一一
怎	乍心丶ㄋ丶丶
呢	口尸丿ㄋㄋㄋ
存	子ㄋ丨一一
未	未丨丿丶丶丶
远	元辶丶ㄋ丶丶
叫	口丩ㄋ丨丨丨
台	厶口丨ㄋ一一
单	单丶丿丨ㄋ一
影	日京丿丿丿丿
具	八丿丶丶丶
罗	罒夕丿ㄋ丶丶
字	宀子ㄋ丨一一
爱	ㄋ丶丶丶
击	凵ㄋ丨丨丨
流	氵丿丨ㄋㄋ
备	夂田丨ㄋ一丨
兵	丘八丿丶丶丶
连	车辶丶ㄋ丶丶
调	讠冂一丨一丨
深	氵冖丿丶一丨
商	冂丿丶丨ㄋ
算	目一丿丨丨
质	十丨ㄋ丿丶
团	囗才一丨丿丿
集	隹木一丨丿丶
百	一白丿丨ㄋ一
需	而一丿丨ㄋ
价	亻人丿丨丨丨
花	艹化丿丨丿ㄋ
党	儿丿ㄋㄋㄋ
华	化十一丨丨丨
城	土戊ㄋㄋㄋㄋ
石	石一丿丨ㄋ一
级	纟及丿ㄋ丶丶
整	束攵一丨一丨
府	广亻一丨丶丶
离	㐫禸丨ㄋㄋ丶
况	冫口丿ㄋㄋㄋ
亚	亚一丨丨丶丿
请	讠青一一丨一
技	扌十ㄋ丶丶丶
际	阝示一一丨丿
约	纟勹丶丶丶丶
示	示一一丨丿丶
复	日丿ㄋ丶丶
病	疒丙丿丶丿丶
息	自心丶ㄋ丶丶
究	穴九丿ㄋㄋㄋ
线	纟戋一一ㄋ丿
似	亻以ㄋ丶丿丶
官	宀㠯丨ㄋ一ㄋ
火	火丶丿丿丶丶
断	米乚丿丿一丨
精	米青一一丨一
满	氵艹一丨ㄋ丿
支	十又ㄋ丶丶丶
视	礻见丨ㄋ丿ㄋ
消	氵丨ㄋ一一
越	走戉一ㄋㄋ丿
器	吅犬丨ㄋ一丨
容	穴人丨ㄋ一一
照	日刀丨ㄋ一丶
须	彡页一丿丨ㄋ
九	九丿ㄋㄋㄋㄋ
增	土曾丶丿丨ㄋ
研	石开一一丿丨
写	冖与一一一一
称	禾尔丿ㄋ丨丿
企	人止丨一丨一
八	八丿丶丶丶丶
功	工力ㄋ丿丿丿
吗	口马ㄋㄋ一一
包	勹巳ㄋ一ㄋㄋ
片	片丿丨一ㄋㄋ
史	口乂丿丶丶丶
委	禾女ㄋ丿一一
乎	乎丿丶丿一丨
查	木旦丨ㄋ一一
轻	车轻ㄋ丶一丨
易	日勿丿ㄋ丿丿
早	日十一丨丨丨
曾	曾丶丿丨ㄋ丨
除	阝亼一丨丿丶
农	农丶ㄋ丿ㄋ丿
找	扌戈一ㄋ丿丶
装	丬士丶一丿ㄋ
广	广丶一丿丿丿
显	日业丨丨丶丿
吧	口巴ㄋ丨一ㄋ
阿	阝可一丨ㄋ一
李	木子ㄋ丨一一
标	木示一一丨丿
谈	讠火丶丿丿丶
吃	口ㄋㄋㄋㄋ
图	囗夂丶丶丶丶
念	今心丶ㄋ丶丶
六	六丶一丿丶丶
引	弓丨丨丨丨丨
历	厂力ㄋ丿丿丿
首	䒑自丿丨ㄋ一
医	匚矢丿一一丿
局	尸丨ㄋ一一
突	穴犬一丿丶丶
专	二㇉丶丶丶丶
费	弓丨ㄋ丿丶
号	口丂一ㄋㄋㄋ
尽	尺⺀丶丶丶丶
另	口力ㄋ丿丿丿
周	冂吉一丨一丨
较	车六丿丶丶丶
注	氵主丶一一丨
语	讠五丨ㄋ一一
仅	亻又ㄋ丶丶丶
考	耂与一ㄋㄋㄋ
落	落各丿ㄋ丶丨
青	青一一丨一丨
随	阝丨ㄋ一一
选	先辶丶ㄋ丶丶
列	歹刂丨丨丨丨
武	一弋丨一丨一
红	纟工一丨一一
响	口丨ㄋ一一
虽	口虫丨ㄋ一丨
推	扌隹丿丨丶一
势	执力ㄋ丿丿丿
参	彡丿丿丿丿
希	乂丨ㄋ丨丨
古	古一丨丨ㄋ一
众	人从丿丶丿丶
构	木勹ㄋ丶丶丶
房	户方丶一ㄋ丿
半	半丶丿一一丨
节	艹卩ㄋ丨丨丨
土	土一丨一一一
投	扌殳丿ㄋㄋ丶
某	甘木一丨丿丶
案	宀女一丨丿丶
黑	黑丨ㄋ丶丿一
维	纟隹丿丨丶一
革	革一丨丨一丨
划	戈刂丨丨丨丨
敌	舌攵丿一丿丶
致	至攵丿一丿丶
陈	阝丨丿丶丶
律	彳聿ㄋ一一一
足	口龰丨一丿丶
态	大丶丶ㄋ丶丶
护	扌户丶ㄋ一丿
七	七一ㄋㄋㄋㄋ
兴	八丿丶丶丶
派	氵丿ㄋ丿丶
孩	孑亥丶一ㄋ丿
验	马亼丶丶丿一
责	贝丨ㄋ丿丶
营	口丨ㄋ一一
星	日生丿一一丨
够	勹口丿ㄋ丶丿
章	音十一丨丨丨
音	音丶一丶丿一
跟	艮ㄋ一一ㄋ
志	士心丶ㄋ丶丶
底	广氏丶丶丶丶
站	立占丨一丨ㄋ
严	亚丿丿丿丿丿
巴	巴ㄋ丨一ㄋㄋ
例	亻歹丨丨丨丨
防	阝方丶一ㄋ丿
族	族矢丿一一丿
供	亻共一丨丨一
效	六乂丿一丿丶
续	纟十ㄋ丶丶一
施	族也ㄋ丨ㄋㄋ
留	田丨ㄋ一丨
讲	讠井一一丿丨
型	开刂一丨一一
料	米⺀一丨丨丨
终	纟夂丶丶丶丶
答	合丿丶一丨
紧	糸ㄋㄋ丶丨
黄	由丿丶丶丶
绝	纟ㄋ丨一ㄋ
奇	大可一丨ㄋ一
察	宀一一丨丿
母	母ㄋㄋ丶一丶
京	京丶一丨ㄋ一
段	段丿丨一一一
依	亻衣丶一丿ㄋ
批	扌比一ㄋ丿ㄋ
群	尹口丶丿一一
项	工页一丿丨ㄋ
故	古攵丿一丿丶
按	扌宀ㄋ丿一一
河	氵可一丨ㄋ一
米	米丶丿一丨丿
围	囗韦一一ㄋ丨
江	氵工一丨一一
织	纟口丿丶丶丶
害	宀丰丨ㄋ一一
斗	⺀十一丨丨丨
双	双ㄋ丶ㄋ丶丶
境	土音丿ㄋㄋㄋ
客	宀各丿ㄋ丶丨
纪	纟己ㄋ一ㄋㄋ
采	爫木一丨丿丶
举	八一一丨丨
杀	乂朩一丨丿丶
攻	工攵丿一丿丶
父	父丿丶丿丶丶
苏	艹力丿丶丶丶
密	宀心丿丨ㄋ丨
低	亻氏丶丶丶丶
朝	月丿ㄋ一一
友	又ㄋ丶丶丶
诉	讠斤丶丶丶丶
止	止丨一丨一一
愿	厂白丨丿丶丶
细	纟田丨ㄋ一丨
千	千丿一丨丨丨
值	亻直一丨丨ㄋ
仍	亻乃ㄋ丿丿丿
男	田力ㄋ丿丿丿
钱	钅戋一一ㄋ丿
破	石皮ㄋ丿丨ㄋ
网	冂乂丿丶丶丶
热	执灬丶丶丶丶
助	且力ㄋ丿丿丿
倒	亻至丨丨丨丨
育	⺝丨ㄋ一一
属	尸丿丨ㄋ一丨
坐	从土一丨一一
帝	巾丨ㄋ丨丨
限	阝艮ㄋ一一ㄋ
船	舟几丨ㄋ一一
脸	月亼丶丶丿一
职	耳口丿丶丶丶
速	束辶丶ㄋ丶丶
刻	亥刂丨丨丨丨
乐	小丨丿丶丶
否	不口丨ㄋ一一
刚	冂㐅丨丨丨丨
威	戊一ㄋ丿一一
毛	毛丿一一ㄋㄋ
状	丬犬一丿丶丶
率	亠幺丶一丿丶
甚	其乚ㄋㄋㄋㄋ
独	犭虫丨ㄋ一丨
球	王求一丨丶一
般	舟殳丿ㄋㄋ丶
普	䒑业丨ㄋ一一
怕	忄白丿丨ㄋ一
弹	弓单丶丿丨ㄋ
校	木六丿丶丶丶
苦	艹古一丨丨ㄋ
创	人丨丨丨丨
假	亻叚ㄋ一丨一
久	久丿ㄋ丶丶丶
错	钅龷丨ㄋ一一
承	了三ㄋ丿丶丶
印	一ㄋ丨丨丨
晚	日丿ㄋㄋㄋ
兰	䒑二一一一一
试	讠弋一丨一一
股	月殳丿ㄋㄋ丶
拿	合手丿一一丨
脑	月㐫丶一丿丶
预	予页一丿丨ㄋ
谁	讠隹丿丨丶一
益	䒑八丨ㄋ丨丨
阳	阝日丨ㄋ一一
若	艹丨ㄋ一一
哪	口ㄋ丨丨丨
微	几丿ㄋㄋㄋ
尼	尸匕丿ㄋㄋㄋ
继	纟米ㄋㄋㄋㄋ
送	䒑大丶ㄋ丶丶
急	刍心丶ㄋ丶丶
血	丿皿丨ㄋ丨丨
惊	忄京丶一丨ㄋ
伤	亻ㄋ丿丿丿
素	糸ㄋㄋ丶丨
药	艹纟丿ㄋ丶丶
适	舌辶丶ㄋ丶丶
波	氵皮ㄋ丿丨ㄋ
夜	亠亻丿ㄋ丶丶
省	少目丨ㄋ一一
初	衤刀ㄋ丿丿丿
喜	壴口丨ㄋ一一
卫	卩一一一一一
源	氵厂丿丨ㄋ一
食	食丿丶丶ㄋ一
险	阝亼丶丶丿一
待	彳土一丨丶丶
述	木丶丶ㄋ丶丶
陆	阝ㄋ丨丨丨
习	习ㄋ丶一一一
置	罒直一丨丨ㄋ
居	尸古一丨丨ㄋ
劳	力ㄋ丿丿丿
财	贝才一丨丿丿
环	王不一丿丨丶
排	扌非丨一一一
福	礻丨ㄋ一丨
纳	纟内丨ㄋ丿丶
欢	又欠丿ㄋ丿丶
雷	田丨ㄋ一丨
警	芍口丿一丿丶
获	艹犭一丿丶丶
模	木莫一丨丨丨
充	儿丿ㄋㄋㄋ
负	贝丨ㄋ丿丶
云	云一一ㄋ丶丶
停	亻一丨丨丨
木	木一丨丿丶丶
游	氵族ㄋ丨一一
龙	龙一丿ㄋ丿丶
树	木又一丨丶丶
疑	匕矢ㄋ丶ㄋ丨
层	尸云一一ㄋ丶
冷	冫令丿丶丶ㄋ
洲	氵川丶丶丶丶
冲	冫中丨ㄋ一丨
射	身寸一丨丶丶
略	田各丿ㄋ丶丨
竟	音儿丿ㄋㄋㄋ
范	落ㄋㄋㄋㄋ
句	勹口丨ㄋ一一
室	宀至一ㄋ丶一
异	巳廾一丿丨丨
激	氵白丶一ㄋ丿
汉	氵又ㄋ丶丶丶
村	木寸一丨丶丶
哈	口合丿丶一丨
演	氵宀一丨ㄋ一
策	朿一丨ㄋ丨
简	门丨ㄋ一一
卡	上卜丨丶丶丶
罪	罒非丨一一一
判	半刂丨丨丨丨
担	扌旦丨ㄋ一一
州	川丶丶丶丶
静	青争丿ㄋㄋ一
退	艮辶丶ㄋ丶丶
既	旡一ㄋ丿ㄋ
衣	衣丶一丿ㄋ丿
您	亻尔丶ㄋ丶丶
宗	宀示一一丨丿
积	禾口丿丶丶丶
余	亼朩一丨丿丶
痛	疒甬ㄋ丶丨ㄋ
检	木亼丶丶丿一
差	工一丨一一
富	宀丨ㄋ一丨
灵	彐火丶丿丿丶
协	十力丿丶丶丶
角	角丿ㄋ丿ㄋ一
占	占丨一丨ㄋ一
配	酉己ㄋ一ㄋㄋ
征	彳正一丨一丨
修	夂丿丿丿丿
皮	皮ㄋ丿丨ㄋ丶
挥	扌冖一ㄋ一丨
胜	月生丿一一丨
降	阝夂一ㄋ丨丨
阶	阝人丿丨丨丨
审	宀日丨丨丨丨
沉	氵冖丿ㄋㄋㄋ
坚	土一丨一一
善	羊䒑丨ㄋ一一
妈	女马ㄋㄋ一一
刘	文刂丨丨丨丨
读	讠十ㄋ丶丶一
啊	口阝一丨ㄋ一
超	走刀丨ㄋ一一
免	儿丿ㄋㄋㄋ
压	厂土丶丶丶丶
银	钅艮ㄋ一一ㄋ
买	乛゛一丿丶丶
皇	白王一一丨一
养	羊丶丿丨丨丨
伊	亻尹ㄋ一一丿
怀	忄不一丿丨丶
执	执一丨一丿ㄋ
副	田丨丨丨丨
乱	舌乚ㄋㄋㄋㄋ
抗	扌亠丿ㄋㄋㄋ
犯	犭ㄋㄋㄋㄋ
追	丿㠯丶ㄋ丶丶
帮	阝丨ㄋ丨丨
宣	宀一丨ㄋ一一
佛	亻弓丿丨丨丨
岁	山夕丿ㄋ丶丶
航	舟亠丿ㄋㄋㄋ
优	亻尢丶丶丶丶
怪	忄又一丨一一
香	禾日丨ㄋ一一
著	艹者一丨一丿
田	田丨ㄋ一丨一
铁	钅丿一一丿丶
控	扌穴一丨一一
税	禾𠮦丿ㄋㄋㄋ
左	工一丨一一
右	口丨ㄋ一一
份	亻分丿丶ㄋ丿
穿	穴牙一ㄋ丨丿
艺	艹乙ㄋㄋㄋㄋ
背	北⺝丨ㄋ一一
阵	阝车一ㄋ一丨
草	艹日一丨丨丨
脚	月去ㄋ丨丨丨
概	木一ㄋ丿ㄋ
恶	亚心丶ㄋ丶丶
块	土丿丶丶丶
顿	屯页一丿丨ㄋ
敢	乛耳丿一丿丶
守	宀寸一丨丶丶
酒	氵酉一丨ㄋ丿
岛	山丨ㄋ丨丨
托	扌丿一ㄋㄋㄋ
央	冂大一丿丶丶
户	户丶ㄋ一丿丿
烈	歹刂丶丶丶丶
洋	氵羊丶丿一一
哥	可可一丨ㄋ一
索	糸ㄋㄋ丶丨
胡	古月丿ㄋ一一
款	士示丿ㄋ丿丶
靠	告非丨一一一
评	讠平一丶丿一
版	片ㄋ丶丶丶
宝	宀王丶丶丶丶
座	广从一丨一一
释	釆又一一丨丨
景	日京丶一丨ㄋ
顾	厂一丿丿丿
弟	弟丶丿ㄋ一ㄋ
登	癶豆一丨ㄋ一
货	化贝丨ㄋ丿丶
互	一彑ㄋㄋ一一
付	亻寸一丨丶丶
伯	亻白丿丨ㄋ一
慢	忄日丨ㄋ丨丨
欧	区欠丿ㄋ丿丶
换	扌丨ㄋ一丿
闻	门耳一丨丨一
危	厃ㄋㄋㄋㄋ
忙	忄亡丶一ㄋㄋ
核	木亥丶一ㄋ丿
暗	日音丶一丶丿
姐	女且丨ㄋ一一
介	人丿丨丨丨
坏	土不一丿丨丶
讨	讠寸一丨丶丶
丽	丽一丨ㄋ丶丨
良	丶艮ㄋ一一ㄋ
序	广予ㄋ丶ㄋ丨
升	丿廾一丿丨丨
监	皿丨ㄋ丨丨
临	丶丨ㄋ丨
亮	几丿ㄋㄋㄋ
露	丿ㄋ丶丨
永	丶㇉ㄋ丿丶丶
呼	口乎丿丶丿一
味	口未丨丿丶丶
野	里予ㄋ丶ㄋ丨
架	加木一丨丿丶
域	土戈丨ㄋ一一
沙	氵少丨丿丶丿
掉	扌⺊丨ㄋ一一
括	扌舌丿一丨丨
舰	舟见丨ㄋ丿ㄋ
鱼	鱼丿ㄋ丨ㄋ一
杂	九朩一丨丿丶
误	讠口一一丿丶
湾	氵亦ㄋ一ㄋㄋ
吉	吉一丨一丨ㄋ
减	冫戊一丨ㄋ一
编	纟户丨ㄋ一丨
楚	林疋ㄋ丨一丿
肯	止⺝丨ㄋ一一
测	氵贝丨丨丨丨
败	贝攵丿一丿丶
屋	尸至一ㄋ丶一
跑	勹ㄋ一ㄋㄋ
梦	林夕丿ㄋ丶丶
散	⺝丿一丿丶
温	氵日丨ㄋ丨丨
困	囗木一丨丿丶
剑	亼丨丨丨丨
渐	氵车丿丿一丨
封	圭寸一丨丶丶
救	求攵丿一丿丶
贵	贝丨ㄋ丿丶
枪	木人ㄋㄋㄋㄋ
缺	缶丿丶丶丶
楼	木米ㄋ丿一一
县	且厶ㄋ丶丶丶
尚	冂丨ㄋ一一
毫	毛丿一一ㄋ
移	禾夕丿ㄋ丶丶
娘	女丶ㄋ一一ㄋ
朋	月月丿ㄋ一一
画	一田ㄋ丨丨丨
班	王一一丨一
智	矢口丨ㄋ一一
亦	亦丶一丿丨丿
耳	耳一丨丨一一
恩	因心丶ㄋ丶丶
短	矢豆一丨ㄋ一
掌	手丿一一丨
恐	工几丶丶ㄋ丶
遗	贝丶ㄋ丶丶
固	囗古一丨丨ㄋ
席	度巾丨ㄋ丨丨
松	木公丿丶ㄋ丶
秘	禾心丿丿丿丿
谢	讠身一丨丶丶
鲁	鱼日丨ㄋ一一
遇	日⽱丶ㄋ丶丶
康	广丨丶一丿
虑	虍心丶ㄋ丶丶
幸	土丶丿一一
均	土勹丶一一一
销	钅丨ㄋ一一
钟	钅中丨ㄋ一丨
诗	讠土一丨丶丶
藏	艹戊ㄋㄋㄋㄋ
赶	走干一一丨丨
剧	尸古丨丨丨丨
票	覀示一一丨丿
损	扌口丨ㄋ丿丶
忽	勿心丶ㄋ丶丶
巨	匚ㄋ一一一
炮	火勹ㄋ一ㄋㄋ
旧	丨日丨ㄋ一一
端	立山一丿丨ㄋ
探	扌冖丿丶一丨
湖	氵古丿ㄋ一一
录	水丨ㄋ丿丶
叶	口十一丨丨丨
春	日丨ㄋ一一
乡	丿丿丿丿丿
附	阝亻一丨丶丶
吸	口及丿ㄋ丶丶
予	予ㄋ丶ㄋ丨丨
礼	礻乚ㄋㄋㄋㄋ
港	氵共ㄋ一ㄋㄋ
雨	雨一丨ㄋ丨丶
呀	口牙一ㄋ丨丿
板	木ㄋ丶丶丶
庭	广壬ㄋ丶丶丶
妇	女彐ㄋ一一一
归	彐ㄋ一一一
睛	目青一一丨一
饭	饣ㄋ丶丶丶
额	宀各一丿丨ㄋ
含	今口丨ㄋ一一
顺	川页一丿丨ㄋ
输	车亼丨ㄋ一一
摇	扌爫丿一一丨
招	扌刀丨ㄋ一一
婚	女氏丨ㄋ一一
脱	月𠮦丿ㄋㄋㄋ
补	衤卜丨丶丶丶
谓	讠田丨ㄋ一一
督	上小ㄋ丶丨ㄋ
毒	母ㄋㄋ丶一
油	氵由丨ㄋ一丨
疗	疒了ㄋ丨丨丨
旅	族丿ㄋ丿丶
泽	氵又一一丨丨
材	木才一丨丿丿
灭	一火丶丿丿丶
逐	豕辶丶ㄋ丶丶
莫	莫一丨丨丨ㄋ
笔	毛丿一一ㄋ
亡	亡丶一ㄋㄋㄋ
鲜	鱼羊丶丿一一
词	讠一丨ㄋ一
圣	又土一丨一一
择	扌又一一丨丨
寻	彐寸一丨丶丶
厂	厂一丿丿丿丿
睡	目垂丿一丨一
博	十甫一丨丶丶
勒	革力ㄋ丿丿丿
烟	火因丨ㄋ一丿
授	扌ㄋ丶丶丶
诺	讠艹一丿丨ㄋ
伦	亻仑丿丶丿ㄋ
岸	山厂一一丨丨
奥	米一丿丶丶
唐	广肀丨ㄋ一一
卖	十乛丶丶一丿
俄	亻我丿一丨一
炸	火乍丿一丨一
载	车一ㄋ一丨
洛	氵各丿ㄋ丶丨
健	亻聿ㄋ丶丶丶
堂	土一丨一一
旁	方丶一ㄋ丿
宫	宀口丨ㄋ一一
喝	口日丿ㄋ丿丶
借	亻龷丨ㄋ一一
君	尹口丨ㄋ一一
禁	林示一一丨丿
阴	阝月丿ㄋ一一
园	囗元一一丿ㄋ
谋	讠甘一丨丿丶
宋	宀木一丨丿丶
避	辟辶丶ㄋ丶丶
抓	扌爪丿丿丨丶
荣	木一丨丿丶
姑	女古一丨丨ㄋ
孙	孑小丨丿丶丶
逃	儿丶ㄋ丶丶
牙	牙一ㄋ丨丿丿
束	束一丨ㄋ一丨
跳	儿丶一丿丶
顶	丁页一丿丨ㄋ
玉	王丶丶丶丶丶
镇	钅直丿丶丶丶
雪	彐ㄋ一一一
午	十一丨丨丨
练	纟ㄋ丿丶丶
爷	父卩ㄋ丨丨丨
迫	白辶丶ㄋ丶丶
篇	户丨ㄋ一丨
肉	内人丿丶丶丶
嘴	口此丿ㄋ丿ㄋ
馆	饣宀丨ㄋ一ㄋ
遍	户丶ㄋ丶丶
凡	几丶丶丶丶丶
础	石屮ㄋ丨丨丨
洞	氵冂一丨ㄋ一
卷	ㄋㄋㄋㄋ
坦	土旦丨ㄋ一一
牛	牛丿一一丨丨
宁	宀丁一丨丨丨
纸	纟氏丿ㄋ一ㄋ
诸	讠者一丨一丿
训	讠川丿丨丨丨
私	禾厶ㄋ丶丶丶
庄	广土一丨一一
祖	礻且丨ㄋ一一
丝	一一一一
翻	釆田ㄋ丶一ㄋ
暴	日共丨丶一丿
森	木林一丨丿丶
塔	土艹丿丶一丨
默	黑犬一丿丶丶
握	扌尸一ㄋ丶一
戏	又戈一ㄋ丿丶
隐	阝刍丶ㄋ丶丶
熟	孑丿ㄋ丶丶
骨	骨丨ㄋㄋ丶ㄋ
访	讠方丶一ㄋ丿
弱	弓冫ㄋ一ㄋ丶
蒙	一一丿ㄋ丿
歌	可可丿ㄋ丿丶
店	广占丨一丨ㄋ
鬼	鬼丿丨ㄋ一一
软	车欠丿ㄋ丿丶
典	曲八丿丶丶丶
欲	八人丨ㄋ一丿
萨	艹阝丶一丶丿
伙	亻火丶丿丿丶
遭	一曲丨ㄋ一一
盘	舟皿丨ㄋ丨丨
爸	父巴ㄋ丨一ㄋ
扩	扌广丶一丿丿
盖	皿丨ㄋ丨丨
弄	王廾一丿丨丨
雄	厶丿丨丶一
稳	禾刍丶ㄋ丶丶
忘	亡心丶ㄋ丶丶
亿	亻乙ㄋㄋㄋㄋ
刺	朿刂丨丨丨丨
拥	扌用丿ㄋ一一
徒	彳走一丨一丨
姆	女母ㄋㄋ丶一
杨	木㇡丿丿丿丿
齐	文丿丨丨丨
赛	寒贝丨ㄋ丿丶
趣	走耳ㄋ丶丶丶
曲	曲丨ㄋ一丨丨
刀	刀ㄋ丿丿丿丿
床	广木一丨丿丶
迎	卩丶ㄋ丶丶
冰	冫水丨ㄋ丿丶
虚	虍业丨丨丶丿
玩	王元一一丿ㄋ
析	木斤丿丿一丨
窗	穴丿ㄋ丶一
醒	酉日丿一一丨
妻	一肀ㄋ丿一一
透	禾乃丶ㄋ丶丶
购	贝勹ㄋ丶丶丶
替	夫夫丨ㄋ一一
塞	寒土一丨一一
努	奴力ㄋ丿丿丿
休	亻木一丨丿丶
虎	虍几丿ㄋㄋㄋ
扬	扌㇡丿丿丿丿
途	亼朩丶ㄋ丶丶
侵	亻彐丶ㄋㄋ丶
刑	开刂丨丨丨丨
绿	纟丨ㄋ丿丶
兄	口儿丿ㄋㄋㄋ
迅	十丶ㄋ丶丶
套	大镸一丨一一
贸	贝丨ㄋ丿丶
毕	比十一丨丨丨
唯	口隹丿丨丶一
谷	八人丨ㄋ一一
轮	车仑丿丶丿ㄋ
库	广车一ㄋ一丨
迹	亦辶丶ㄋ丶丶
尤	尢丶丶丶丶丶
竞	立口丿ㄋㄋㄋ
街	彳圭一一丨丨
促	亻口丨一丿丶
延	丿止ㄋ丶丶丶
震	辰一丿一一
弃	廾一丿丨丨
甲	甲丨ㄋ一一丨
伟	亻韦一一ㄋ丨
麻	麻丶一丿一丨
川	川丿丨丨丨丨
申	日丨丨丨丨丨
缓	纟爫一一丿ㄋ
潜	氵夫一一丿丶
闪	门人丿丶丶丶
售	隹口丨ㄋ一一
灯	火丁一丨丨丨
针	钅十一丨丨丨
哲	折口丨ㄋ一一
络	纟各丿ㄋ丶丨
抵	扌氏丶丶丶丶
朱	丿未丨丿丶丶
埃	土厶丿一一丿
抱	扌勹ㄋ一ㄋㄋ
鼓	壴十ㄋ丶丶丶
植	木直一丨丨ㄋ
纯	纟屯一ㄋ丨ㄋ
夏	丆目丿ㄋ丶丶
忍	刀丶丶ㄋ丶丶
页	页一丿丨ㄋ丿
杰	木灬丶丶丶丶
筑	工丿ㄋ丶丶
折	折一丨一丿丿
郑	䒑大ㄋ丨丨丨
贝	贝丨ㄋ丿丶丶
尊	酋寸一丨丶丶
吴	口天一一丿丶
秀	禾乃ㄋ丿丿丿
混	氵日一ㄋ丿ㄋ
臣	臣一丨ㄋ一丨
雅	牙隹丿丨丶一
振	扌辰一丿一一
染	氵九一丨丿丶
盛	戊丨ㄋ丨丨
怒	奴心丶ㄋ丶丶
舞	卌丿ㄋ丶一
圆	囗口丨ㄋ丿丶
搞	扌丨ㄋ一一
狂	犭王一一丨一
措	扌龷丨ㄋ一一
姓	女生丿一一丨
秋	禾火丶丿丿丶
残	歹戋一一ㄋ丿
培	土立丨ㄋ一一
迷	米辶丶ㄋ丶丶
诚	讠戊ㄋㄋㄋㄋ
宽	宀艹丨ㄋ丿ㄋ
宇	宀于一一丨丨
猛	犭子丨ㄋ丨丨
摆	扌罒一丨一ㄋ
梅	木ㄋㄋ丶一
毁	臼工丿ㄋㄋ丶
伸	亻日丨丨丨丨
摩	麻手丿一一丨
盟	日月丨ㄋ丨丨
末	一木一丨丿丶
乃	乃ㄋ丿丿丿丿
悲	非心丶ㄋ丶丶
拍	扌白丿丨ㄋ一
丁	丁一丨丨丨丨
赵	走乂丿丶丶丶
硬	石更一丨ㄋ一
麦	夂丿ㄋ丶丶
蒋	艹丬丿ㄋ丶丶
操	扌口丨ㄋ一丨
耶	耳阝ㄋ丨丨丨
阻	阝且丨ㄋ一一
订	讠丁一丨丨丨
彩	爫木丿丿丿丿
抽	扌由丨ㄋ一丨
赞	先先丨ㄋ丿丶
魔	麻鬼丿丨ㄋ一
纷	纟分丿丶ㄋ丿
沿	氵几丨ㄋ一一
喊	口戊一丨ㄋ一
违	韦辶丶ㄋ丶丶
妹	女未丨丿丶丶
浪	氵丶ㄋ一一ㄋ
汇	氵匚一ㄋㄋㄋ
币	丿巾丨ㄋ丨丨
丰	丰一一一丨丨
蓝	艹丨ㄋ丨丨
殊	歹丿丨丿丶丶
献	十冂丶丿一一
桌	⺊日一丨丿丶
啦	口扌丶一丶丿
瓦	瓦一ㄋㄋ丶丶
莱	艹夹丨丿丶丶
援	扌爫一一丿ㄋ
译	讠又一一丨丨
夺	大寸一丨丶丶
汽	氵气丿一一ㄋ
烧	火尧一ㄋ丿一
距	匚ㄋ一一一
裁	衣丶一丿ㄋ
偏	亻户丨ㄋ一丨
符	亻一丨丶丶
勇	甬力ㄋ丿丿丿
触	角虫丨ㄋ一丨
课	讠日一丨丿丶
敬	芍口丿一丿丶
哭	吅犬一丿丶丶
懂	忄艹丿一丨丨
墙	土十丶丿一丨
袭	龙衣丶一丿ㄋ
召	刀口丨ㄋ一一
罚	罒讠丨丨丨丨
侠	亻夹丿丶丶丶
厅	厂丁一丨丨丨
拜	一一一一丨
巧	工丂一ㄋㄋㄋ
侧	亻贝丨丨丨丨
韩	韦一一ㄋ丨
冒	日目丨ㄋ一一
债	亻丨ㄋ丿丶
曼	日罒ㄋ丶丶丶
融	鬲虫丨ㄋ一丨
惯	忄毌丨ㄋ丿丶
享	子ㄋ丨一一
戴	田一丨丨一
童	立里丨ㄋ一一
犹	犭尢丶丶丶丶
乘	禾北丨一一丿
挂	扌圭一丨一一
奖	丬夕一丿丶丶
绍	纟刀丨ㄋ一一
厚	厂日ㄋ丨一一
纵	纟从丿丶丿丶
障	阝音一丨丨丨
讯	讠一丨丨丨
涉	氵止丨丿丿丿
彻	彳七ㄋ丿丿丿
刊	干刂丨丨丨丨
丈	丶丶丶丶丶
爆	火日一丨丨一
乌	勹㇉一一一一
役	彳殳丿ㄋㄋ丶
描	扌艹丨ㄋ一丨
洗	氵先丿一丨一
玛	王马ㄋㄋ一一
患	口中丶ㄋ丶丶
妙	女少丨丿丶丿
镜	钅音丿ㄋㄋㄋ
唱	口日丨ㄋ一一
烦	火页一丿丨ㄋ
签	亼丶丶丿一
仙	亻山丨ㄋ丨丨
彼	彳皮ㄋ丿丨ㄋ
弗	弓丿丨丨丨
症	疒正一丨一丨
仿	亻方丶一ㄋ丿
倾	亻一丿丨ㄋ
牌	片卑丿丨ㄋ一
陷	阝丿丨一ㄋ
鸟	鸟丿ㄋ丶ㄋㄋ
轰	车双ㄋ丶ㄋ丶
咱	口自丿丨ㄋ一
菜	艹爫一丨丿丶
闭	门才一丨丿丿
奋	大田丨ㄋ一丨
庆	广大一丿丶丶
撤	扌丨ㄋ一一
泪	氵目丨ㄋ一一
茶	艹人一丨丿丶
疾	疒矢丿一一丿
缘	纟彑丿ㄋ丿丿
播	扌釆丨ㄋ一丨
朗	丶丿ㄋ一一
杜	木土一丨一一
奶	女乃ㄋ丿丿丿
季	禾子ㄋ丨一一
丹	冂亠丶一一一
狗	犭勹丨ㄋ一一
尾	尸毛丿一一ㄋ
仪	亻义丶丿丶丶
偷	亻亼丨ㄋ一一
奔	大十一丿丨丨
珠	王丿丨丿丶丶
虫	虫丨ㄋ一丨一
驻	马主丶一一丨
孔	孑乚ㄋㄋㄋㄋ
宜	宀且丨ㄋ一一
艾	艹乂丿丶丶丶
桥	木夭丿丨丨丨
淡	氵火丶丿丿丶
翼	羽田一丨丨一
恨	忄艮ㄋ一一ㄋ
繁	母丿一丿丶
寒	寒⺀丶丶丶丶
伴	亻半丶丿一一
叹	口又ㄋ丶丶丶
旦	旦丨ㄋ一一一
愈	亼⺝丨丨丶ㄋ
潮	氵丿ㄋ一一
粮	米丶ㄋ一一ㄋ
缩	纟宀丿丶丶丶
罢	罒去一丨一ㄋ
聚	耳又丿丨丿丿
径	彳轻ㄋ丶一丨
恰	忄合丿丶一丨
挑	扌儿丶一丿丶
袋	代衣丶一丿ㄋ
灰	火丶丿丿丶
捕	扌甫一丨ㄋ一
徐	彳亼一丨丿丶
珍	王人丿丿丿丿
幕	莫巾丨ㄋ丨丨
映	日冂一丿丶丶
裂	歹刂丶一丿ㄋ
泰	氺丨丶一丿
隔	阝鬲一丨ㄋ一
启	户口丨ㄋ一一
尖	小大一丿丶丶
忠	中心丶ㄋ丶丶
累	田糸ㄋㄋ丶丨
炎	火火丶丿丿丶
暂	车斤丨ㄋ一一
估	亻古一丨丨ㄋ
泛	氵丿丶ㄋ丶丶
荒	艹亡丿丨ㄋㄋ
偿	亻丶ㄋ一一
横	木丨ㄋ一丨
拒	扌匚ㄋ一一一
瑞	王山一丿丨ㄋ
忆	忄乙ㄋㄋㄋㄋ
孤	孑瓜丿丿ㄋ丶
鼻	自畀丨ㄋ一丨
闹	门亠丨ㄋ丨丨
羊	羊丶丿一一一
呆	呆丨ㄋ一一丨
厉	厂万一ㄋ丿丿
衡	彳丨ㄋ一丨
胞	月勹ㄋ一ㄋㄋ
零	令丿丶丶ㄋ
穷	穴力ㄋ丿丿丿
舍	亼古一丨丨ㄋ
码	石马ㄋㄋ一一
赫	赤赤丿丨丿丶
婆	氵皮ㄋ丿一一
魂	云鬼丿丨ㄋ一
灾	宀火丶丿丿丶
洪	氵共一丨丨一
腿	月艮丶ㄋ丶丶
胆	月旦丨ㄋ一一
津	氵聿ㄋ一一一
俗	亻八丿丶丨ㄋ
辩	辛讠丶一丶丿
胸	月勹丿丶ㄋ丨
晓	日尧一ㄋ丿一
劲	轻力ㄋ丿丿丿
仁	亻二一一一一
贫	分贝丨ㄋ丿丶
偶	亻日丨ㄋ丨一
辑	车口一丨丨一
邦	阝ㄋ丨丨丨
恢	忄丶丿丿丶
赖	束丨ㄋ丿丶
圈	囗ㄋㄋㄋㄋ
摸	扌莫一丨丨丨
仰	亻ㄋ丨丨丨
润	氵门一一丨一
堆	土隹丿丨丶一
碰	石䒑丨丨丶丿
艇	舟壬ㄋ丶丶丶
稍	禾丨ㄋ一一
迟	尺辶丶ㄋ丶丶
辆	车丙丿丶丿丶
废	广发ㄋ丿ㄋ丶
净	冫争丿ㄋㄋ一
凶	㐅凵ㄋ丨丨丨
署	罒者一丨一丿
壁	辟土一丨一一
御	彳丨一丨一
奉	一一丨丨
旋	族疋ㄋ丨一丿
冬	夂⺀丶丶丶丶
矿	石广丶一丿丿
抬	扌厶丨ㄋ一一
蛋	疋虫丨ㄋ一丨
晨	日辰一丿一一
伏	亻犬一丿丶丶
吹	口欠丿ㄋ丿丶
鸡	又鸟丿ㄋ丶ㄋ
倍	亻立丨ㄋ一一
糊	米古丿ㄋ一一
秦	禾丿一丨丿
盾	十丨ㄋ一一
杯	木不一丿丨丶
租	禾且丨ㄋ一一
骑	马大一丨ㄋ一
乏	丿之丶ㄋ丶丶
隆	阝夂一丿一一
诊	讠人丿丿丿丿
奴	奴ㄋ丿一ㄋ丶
摄	扌耳ㄋ丶ㄋ丶
丧	十䒑ㄋ丿丶丶
污	氵二ㄋㄋㄋㄋ
渡	氵度ㄋ丶丶丶
旗	族其一丨丨一
甘	甘一丨丨一一
耐	而寸一丨丶丶
凭	亻壬丿ㄋㄋㄋ
扎	扌乚ㄋㄋㄋㄋ
抢	扌人ㄋㄋㄋㄋ
绪	纟者一丨一丿
粗	米且丨ㄋ一一
肩	户⺝丨ㄋ一一
梁	氵刀丿丶一丨
幻	幺ㄋㄋㄋㄋ
菲	艹非丨一一一
皆	比白丿丨ㄋ一
碎	石亠丿丶丿丶
宙	宀由丨ㄋ一丨
叔	上小ㄋ丶丶丶
岩	山石一丿丨ㄋ
荡	落㇡丿丿丿丿
综	纟宀一一丨丿
爬	爪巴ㄋ丨一ㄋ
荷	荷可一丨ㄋ一
悉	釆心丶ㄋ丶丶
蒂	艹丨ㄋ丨丨
返	又丶ㄋ丶丶
井	井一一丿丨丨
壮	丬士一丨一一
薄	落甫一丨丶丶
悄	忄丨ㄋ一一
扫	扌彐ㄋ一一一
敏	母丿一丿丶
碍	石旦一丨丶丶
殖	歹直一丨丨ㄋ
详	讠羊丶丿一一
迪	由辶丶ㄋ丶丶
矛	矛ㄋ丶ㄋ丨丿
霍	隹丿丨丶一
允	厶儿丿ㄋㄋㄋ
幅	巾丨ㄋ一丨
撒	扌丨ㄋ一一
剩	禾北丨丨丨丨
凯	山己丿ㄋㄋㄋ
颗	日木一丿丿丿
骂	吅马ㄋㄋ一一
赏	贝丨ㄋ丿丶
液	氵亠丿丶丿ㄋ
番	釆田丨ㄋ一丨
箱	相一丨丿丶
贴	贝占丨一丨ㄋ
漫	氵日丨ㄋ丨丨
酸	酉厶丿丶丿ㄋ
郎	丶ㄋ丨丨丨
腰	月覀ㄋ丿一一
舒	亼古ㄋ丶ㄋ丨
眉	目丨ㄋ一一
忧	忄尢丶丶丶丶
浮	氵爫ㄋ丨一一
辛	辛丶一丶丿一
恋	亦心丶ㄋ丶丶
餐	⺊夕ㄋ丶丿丶
吓	口下一丨丶丶
挺	扌壬ㄋ丶丶丶
励	厂万ㄋ丿丿丿
辞	舌辛丶一丶丿
艘	舟臼丨ㄋ丶丶
键	钅聿ㄋ丶丶丶
伍	亻五一丨ㄋ一
峰	山夂一一一丨
尺	尺ㄋ一丿丶丶
昨	日乍丿一丨一
黎	禾勹丿丨丶一
辈	非车一ㄋ一丨
贯	毌贝丨ㄋ丿丶
侦	亻⺊丨ㄋ丿丶
滑	氵骨丨ㄋㄋ丶
券	刀ㄋ丿丿丿
崇	山宀一一丨丿
扰	扌尢丶丶丶丶
宪	宀先丿一丨一
绕	纟尧一ㄋ丿一
趋	走刍丿ㄋㄋ一
慈	䒑幺ㄋㄋ丶丶
乔	夭丿丨丨丨
阅	门𠮦丿ㄋㄋㄋ
汗	氵干一一丨丨
枝	木十ㄋ丶丶丶
拖	扌ㄋ丨ㄋㄋ
墨	黑土一丨一一
胁	月力丿丶丶丶
插	扌千丿丨一ㄋ
箭	前丶丿一丨
腊	月龷丨ㄋ一一
粉	米分丿丶ㄋ丿
泥	氵尸丿ㄋㄋㄋ
氏	氏丿ㄋ一ㄋㄋ
彭	壴彡丿丿丿丿
拔	扌ㄋ丶丶丶
骗	马户丨ㄋ一丨
凤	几又ㄋ丶丶丶
慧	丰丰ㄋ一一丶
媒	女甘一丨丿丶
佩	亻几一丨ㄋ丨
愤	忄十一丨丨丨
扑	扌卜丨丶丶丶
龄	齿令丿丶丶ㄋ
驱	马区一丿丶ㄋ
惜	忄龷丨ㄋ一一
豪	豕一丿ㄋ丿
掩	扌大丨ㄋ一一
兼	兼丶丿一ㄋ一
跃	夭丿一丿丶
尸	尸ㄋ一丿丿丿
肃	肀丿丶丶丶
帕	巾白丿丨ㄋ一
驶	马口丿丶丶丶
堡	亻呆一丨一一
届	尸由丨ㄋ一丨
欣	斤欠丿ㄋ丿丶
惠	一日丨一丶丶
册	冂冂一一一一
储	亻讠一丨一丿
飘	覀示丿ㄋ丿丶
桑	又双一丨丿丶
闲	门木一丨丿丶
惨	忄丿丿丿丿
洁	氵吉一丨一丨
踪	宀一一丨丿
勃	子ㄋ丿丿丿
宾	宀丘丿丶丶丶
频	止一丿丨ㄋ
仇	亻九丿ㄋㄋㄋ
磨	麻石一丿丨ㄋ
递	弟辶丶ㄋ丶丶
邪	牙阝ㄋ丨丨丨
撞	扌立丨ㄋ一一
拟	扌以ㄋ丶丿丶
滚	氵六ㄋ丶丶丶
奏	夭丿一丿丶
巡	巛辶丶ㄋ丶丶
颜	厂丿丿丿一
剂	文丨丨丨丨
绩	纟丨ㄋ丿丶
贡	工贝丨ㄋ丿丶
疯	疒几丿丶丶丶
坡	土皮ㄋ丿丨ㄋ
瞧	目隹丶丶丶丶
截	隹丿丨丶一
燃	火一丿丶丶
焦	隹灬丶丶丶丶
殿	尸共丿ㄋㄋ丶
伪	亻丶ㄋ丿丶丶
柳	木卯丿ㄋ丿ㄋ
锁	钅丨ㄋ丿丶
逼	田丶ㄋ丶丶
颇	皮页一丿丨ㄋ
昏	氏日丨ㄋ一一
劝	又力ㄋ丿丿丿
呈	口王一一丨一
搜	扌臼丨ㄋ丶丶
勤	堇力ㄋ丿丿丿
戒	戈廾一丿丨丨
驾	加马ㄋㄋ一一
漂	氵覀一一丨丿
饮	饣欠丿ㄋ丿丶
曹	一曲丨ㄋ一一
朵	几木一丨丿丶
仔	亻子ㄋ丨一一
柔	矛木一丨丿丶
俩	亻丙丿丶丿丶
孟	子皿丨ㄋ丨丨
腐	广亻一丨丶丨
幼	幺力ㄋ丿丿丿
践	戋一一ㄋ丿
籍	耒一丨丨一
牧	牛攵丿一丿丶
凉	冫京丶一丨ㄋ
牲	牜生丿一一丨
佳	亻圭一丨一一
娜	女ㄋ丨丨丨
浓	氵农丶ㄋ丿ㄋ
芳	艹方丶一ㄋ丿
稿	禾丨ㄋ一一
竹	竹丿一丨丿一
腹	月丨ㄋ一一
跌	丿一一丿丶
逻	罒夕丶ㄋ丶丶
垂	垂丿一丨一丨
遵	酋寸丶ㄋ丶丶
脉	月丶ㄋㄋ丿丶
貌	豸白丿ㄋㄋㄋ
柏	木白丿丨ㄋ一
狱	犭讠一丿丶丶
猜	犭青一一丨一
怜	忄令丿丶丶ㄋ
惑	戈口一丶ㄋ丶
陶	阝勹丿一一丨
兽	丷田一丨ㄋ一
帐	巾长丿一ㄋ丶
饰	饣丨ㄋ丨丨
贷	代贝丨ㄋ丿丶
昌	日日丨ㄋ一一
叙	亼朩ㄋ丶丶丶
躺	身丨ㄋ丨ㄋ
钢	钅冂丿丶丶丶
沟	氵勹ㄋ丶丶丶
寄	宀大一丨ㄋ一
扶	扌夫一一丿丶
铺	钅甫一丨ㄋ一
邓	又阝ㄋ丨丨丨
寿	寸一丨丶丶
惧	忄丿丶丶丶
询	讠勹丨ㄋ一一
汤	氵㇡丿丿丿丿
盗	次皿丨ㄋ丨丨
肥	月巴ㄋ丨一ㄋ
尝	冖一一ㄋ丶
匆	勿丶丶丶丶丶
辉	光冖一ㄋ一丨
奈	大示一一丨丿
扣	扌口丨ㄋ一一
廷	壬廴ㄋ丶丶丶
澳	氵丶丿一丨
嘛	口麻丶一丿一
董	艹千丨ㄋ一一
迁	千辶丶ㄋ丶丶
凝	冫匕丿一一丿
慰	尸示一丨丶丶
厌	厂犬一丿丶丶
脏	月广一丨一一
腾	月ㄋㄋ一一
幽	山幺ㄋㄋ丶丶
怨	夕丶ㄋ丶丶
鞋	革圭一丨一一
丢	丿去一丨一ㄋ
埋	土里丨ㄋ一一
泉	白水丨ㄋ丿丶
涌	氵甬ㄋ丶丨ㄋ
辖	车宀一一一丨
躲	身几一丨丿丶
晋	亚日丨ㄋ一一
紫	此糸ㄋㄋ丶丨
艰	又艮ㄋ一一ㄋ
魏	禾女丿丨ㄋ一
吾	五口丨ㄋ一一
慌	忄艹丶一ㄋ丿
祝	礻口丿ㄋㄋㄋ
邮	由阝ㄋ丨丨丨
吐	口土一丨一一
狠	犭艮ㄋ一一ㄋ
鉴	金丿丶一一
曰	曰丨ㄋ一一一
械	木戈一丿丨丨
咬	口六丿丶丶丶
邻	令阝ㄋ丨丨丨
赤	赤丿丨丿丶丶
挤	扌文丿丨丨丨
椅	木大一丨ㄋ一
弯	亦弓ㄋ一ㄋㄋ
陪	阝立丨ㄋ一一
割	宀丰丨ㄋ一丨
揭	扌日丿ㄋ丿丶
韦	韦一一ㄋ丨丨
悟	忄五丨ㄋ一一
聪	耳𠮦丶ㄋ丶丶
雾	夂ㄋ丿丿丿
锋	钅夂一一一丨
梯	木弟丶丿ㄋ一
祥	礻羊丶丿一一
猫	犭艹丨ㄋ一丨
阔	门氵丿一丨丨
誉	八丶一一一
筹	一丨丶丶
丛	从一一一一一
牵	大冖丿一一丨
鸣	口鸟丿ㄋ丶ㄋ
沈	氵冖丿ㄋㄋㄋ
阁	门各丿ㄋ丶丨
穆	禾白丨丿丶丿
屈	尸屮ㄋ丨丨丨
旨	匕日丨ㄋ一一
袖	衤由丨ㄋ一丨
猎	犭龷丨ㄋ一一
臂	辟⺝丨ㄋ一一
蛇	虫宀丿ㄋㄋㄋ
贺	加贝丨ㄋ丿丶
柱	木主丶一一丨
抛	扌九ㄋ丿丿丿
鼠	鼠丿丨一ㄋ一
瑟	王王丶ㄋ丶丿
戈	戈一ㄋ丿丶丶
牢	宀牛丿一一丨
逊	孑小丶ㄋ丶丶
迈	万辶丶ㄋ丶丶
欺	其欠丿ㄋ丿丶
吨	口屯一ㄋ丨ㄋ
琴	王王丿丶丶ㄋ
衰	一丿ㄋ丿丶
瓶	䒑廾一ㄋㄋ丶
恼	忄㐫丶一丿丶
燕	廿口丨一一丿
仲	亻中丨ㄋ一丨
诱	讠禾ㄋ丿丿丿
狼	犭丶ㄋ一一ㄋ
池	氵也ㄋ丨ㄋㄋ
疼	疒夂丶丶丶丶
卢	⺊尸ㄋ一丿丿
仗	亻丶丶丶丶
冠	冖元一丨丶丶
粒	米立丶一丶丿
遥	爫缶丶ㄋ丶丶
吕	口口丨ㄋ一一
玄	亠幺ㄋㄋ丶丶
尘	小土一丨一一
冯	冫马ㄋㄋ一一
抚	扌一一丿ㄋㄋ
浅	氵戋一一ㄋ丿
敦	孑丿一丿丶
钻	钅占丨一丨ㄋ
纠	纟丩ㄋ丨丨丨
晶	日日丨ㄋ一一
岂	山己ㄋ一ㄋㄋ
峡	山夹丿丶丶丶
苍	艹人ㄋㄋㄋㄋ
喷	口十一丨丨丨
凌	冫土丿丶丿ㄋ
耗	耒毛丿一一ㄋ
敲	口丨一ㄋ丶
菌	艹囗一丨丿丶
赔	贝立丨ㄋ一一
涂	氵亼一丨丿丶
粹	米亠丿丶丿丶
扁	户丨ㄋ一丨
亏	二㇉ㄋㄋㄋㄋ
寂	宀上丨丿丶ㄋ
煤	火甘一丨丿丶
熊	厶⺝丿ㄋ丿ㄋ
恭	共丨丶丶丶
湿	氵日丨丨丶丿
循	彳一丨丨ㄋ
暖	日爫一一丿ㄋ
糖	米广ㄋ一一丨
赋	贝一一ㄋ丶丨
抑	扌ㄋ丨丨丨
秩	禾丿一一丿丶
帽	巾日丨ㄋ一一
哀	丿ㄋ丿丶
宿	宀亻一丿丨ㄋ
踏	水丨ㄋ一一
烂	火䒑一一一一
袁	土口丿ㄋ丿丶
侯	亻丿一一丿
抖	扌⺀一丨丨丨
夹	夹人丿丶丶丶
昆	日比一ㄋ丿ㄋ
肝	月干一一丨丨
擦	扌宀丿ㄋ丶丶
猪	犭者一丨一丿
炼	火ㄋ丿丶丶
恒	忄一丨ㄋ一一
慎	忄直丿丶丶丶
搬	扌舟丿ㄋㄋ丶
纽	纟丑ㄋ丨一一
纹	纟文丶一丿丶
玻	王皮ㄋ丿丨ㄋ
渔	氵鱼丿ㄋ丨ㄋ
磁	石䒑ㄋㄋ丶ㄋ
铜	钅冂一丨ㄋ一
齿	齿丨一丨一丿
跨	大一一ㄋㄋ
押	扌甲丨ㄋ一一
怖	忄丨ㄋ丨丨
漠	氵莫一丨丨丨
疲	疒皮ㄋ丿丨ㄋ
叛	半ㄋ丶丶丶
遣	㠯丶ㄋ丶丶
兹	䒑幺ㄋㄋ丶丶
祭	示一一丨丿
醉	酉亠丿丶丿丶
拳	手丿一一丨
弥	弓尔丿ㄋ丨丿
斜	亼朩丶丶一丨
档	木ㄋ一一一
稀	禾乂一丿丨ㄋ
捷	扌一ㄋ一一丨
肤	月夫一一丿丶
肿	月中丨ㄋ一丨
疫	疒殳丿ㄋㄋ丶
豆	豆一丨ㄋ一丶
削	⺝丨丨丨丨
岗	山冂丿丶丶丶
晃	日光丨丶丿一
吞	天口丨ㄋ一一
宏	宀ㄋ丶丶丶
癌	疒口丨ㄋ一丨
肚	月土一丨一一
隶	氺丨丶一丿
履	尸彳丿一丨ㄋ
涨	氵弓丿一ㄋ丶
耀	光羽丿丨丶一
扭	扌丑ㄋ丨一一
坛	土云一一ㄋ丶
沃	氵夭丿一丿丶
拨	扌发ㄋ丿ㄋ丶
绘	纟人一一ㄋ丶
伐	亻戈一ㄋ丿丶
堪	土其ㄋㄋㄋㄋ
仆	亻卜丨丶丶丶
郭	孑ㄋ丨丨丨
牺	牜西一丨ㄋ丿
歼	歹千丿一丨丨
墓	莫土一丨一一
雇	户隹丿丨丶一
廉	广兼丶丿一ㄋ
契	丰刀一丿丶丶
拼	扌䒑一丿丨丨
惩	彳正丶ㄋ丶丶
捉	扌口丨一丿丶
覆	覀彳丿一丨ㄋ
刷	尸巾丨丨丨丨
劫	去力ㄋ丿丿丿
嫌	女兼丶丿一ㄋ
瓜	瓜丿丿ㄋ丶丶
歇	日勹丿丶ㄋ丿
雕	冂吉丿丨丶一
闷	门心丶ㄋ丶丶
乳	爫子ㄋㄋㄋㄋ
串	口中丨ㄋ一丨
娃	女圭一丨一一
缴	纟白丶一ㄋ丿
唤	口丨ㄋ一丿
赢	赢贝丨ㄋ丿丶
莲	艹车丶ㄋ丶丶
桃	木儿丶一丿丶
霸	革丿ㄋ一一
妥	爫女ㄋ丿一一
瘦	疒臼丨ㄋ丶丶
搭	扌艹丿丶一丨
赴	走卜丨丶丶丶
岳	丘山丨ㄋ丨丨
嘉	壴加ㄋ丿丨ㄋ
舱	舟人ㄋㄋㄋㄋ
俊	亻厶丿丶丿ㄋ
址	土止丨一丨一
庞	广龙一丿ㄋ丿
耕	耒井一一丿丨
锐	钅𠮦丿ㄋㄋㄋ
缝	纟夂一一一丨
悔	忄ㄋㄋ丶一
邀	白方丿一丿丶
玲	王令丿丶丶ㄋ
惟	忄隹丿丨丶一
宅	宀丿一ㄋㄋㄋ
斥	斤丶丶丶丶丶
添	氵天丨丶丶丶
挖	扌穴ㄋㄋㄋㄋ
呵	口可一丨ㄋ一
讼	讠公丿丶ㄋ丶
氧	气羊丶丿一一
浩	氵告丿一丨一
羽	羽ㄋ丶一ㄋ丶
斤	斤丿丿一丨丨
酷	酉告丿一丨一
掠	扌京丶一丨ㄋ
妖	女夭丿一丿丶
祸	礻口丨ㄋ丿丶
侍	亻土一丨丶丶
乙	乙ㄋㄋㄋㄋㄋ
妨	女方丶一ㄋ丿
贪	今贝丨ㄋ丿丶
挣	扌争丿ㄋㄋ一
汪	氵王一一丨一
尿	尸水丨ㄋ丿丶
莉	艹禾丨丨丨丨
悬	且厶丶ㄋ丶丶
唇	辰口丨ㄋ一一
翰	人ㄋ丶一ㄋ
仓	人ㄋㄋㄋㄋ
轨	车九丿ㄋㄋㄋ
枚	木攵丿一丿丶
盐	土卜丨ㄋ丨丨
览	见丨ㄋ丿ㄋ
傅	亻甫一丨丶丶
帅	巾丨ㄋ丨丨
庙	广由丨ㄋ一丨
芬	艹分丿丶ㄋ丿
屏	尸䒑一丿丨丨
寺	土寸一丨丶丶
胖	月半丶丿一一
璃	王㐫丨ㄋㄋ丶
愚	日⽱丶ㄋ丶丶
滴	氵丨ㄋ一丨
疏	乛止丶一ㄋ丶
萧	艹肀丿丨丿丶
姿	次女ㄋ丿一一
颤	亠回丨ㄋ一一
丑	丑ㄋ丨一一一
劣	少力ㄋ丿丿丿
柯	木可一丨ㄋ一
寸	寸一丨丶丶丶
扔	扌乃ㄋ丿丿丿
盯	目丁一丨丨丨
辱	辰寸一丨丶丶
匹	匚儿丿ㄋㄋㄋ
俱	亻丿丶丶丶
辨	辛丶一丶丿
饿	饣我丿一丨一
蜂	虫夂一一一丨
哦	口我丿一丨一
腔	月穴一丨一一
郁	⺝ㄋ丨丨丨
溃	氵丨ㄋ丿丶
糟	米一丨ㄋ一丨
谨	讠堇一丨丨一
葛	艹日丿ㄋ丿丶
苗	艹田丨ㄋ一丨
肠	月㇡丿丿丿丿
忌	己心丶ㄋ丶丶
溜	氵丨ㄋ一丨
鸿	氵工丿ㄋ丶ㄋ
爵	爫罒ㄋ一一ㄋ
鹏	月月丿ㄋ丶ㄋ
鹰	广亻丿丨丶一
笼	龙一丿ㄋ丿
丘	丘丿丨一丨一
桂	木圭一丨一一
滋	氵䒑ㄋㄋ丶ㄋ
聊	耳卯丿ㄋ丿ㄋ
挡	扌ㄋ一一一
纲	纟冂丿丶丶丶
肌	月几丿ㄋㄋㄋ
茨	艹次丶一丿ㄋ
壳	几丿ㄋㄋㄋ
痕	疒艮ㄋ一一ㄋ
碗	石宀丿ㄋ丶ㄋ
穴	穴丶丶ㄋ丿丶
膀	月丶一ㄋ丿
卓	⺊日一丨丨丨
贤	贝丨ㄋ丿丶
卧	臣卜丨丶丶丶
膜	月莫一丨丨丨
毅	立豕丿ㄋㄋ丶
锦	钅白丨ㄋ丨丨
欠	欠丿ㄋ丿丶丶
哩	口里丨ㄋ一一
函	了ㄋ丨丨丨
茫	落亡丶一ㄋㄋ
昂	日ㄋ丨丨丨
薛	艹丿丨ㄋ一ㄋ
皱	刍皮ㄋ丿丨ㄋ
夸	大二ㄋㄋㄋㄋ
豫	予象丿ㄋ丨ㄋ
胃	田⺝丨ㄋ一一
舌	舌丿一丨丨ㄋ
剥	水丨丨丨丨
傲	亻敖一一丨一
拾	扌合丿丶一丨
窝	穴口丨ㄋ丿丶
睁	目争丿ㄋㄋ一
携	扌隹ㄋ丿丿丿
陵	阝土丿丶丿ㄋ
哼	口ㄋ丨丨丨
棉	木白丨ㄋ丨丨
晴	日青一一丨一
铃	钅令丿丶丶ㄋ
填	土直丿丶丶丶
饲	饣一丨ㄋ一
吻	口勿丿ㄋ丿丿
渴	氵日丿ㄋ丿丶
扮	扌分丿丶ㄋ丿
逆	屰辶丶ㄋ丶丶
脆	月厃ㄋㄋㄋㄋ
喘	口山一丿丨ㄋ
罩	罒⺊丨ㄋ一一
卜	卜丨丶丶丶丶
炉	火户丶ㄋ一丿
柴	此木一丨丿丶
愉	忄亼丨ㄋ一一
绳	纟口丨ㄋ一一
胎	月厶丨ㄋ一一
蓄	艹亠ㄋㄋ丶丶
眠	目民ㄋ一ㄋ一
竭	立日丿ㄋ丿丶
喂	口田一ㄋ丿丶
傻	亻丿丶一丿
慕	莫丨丶丶丶
浑	氵冖一ㄋ一丨
奸	女干一一丨丨
扇	户羽ㄋ丶一ㄋ
柜	木匚ㄋ一一一
悦	忄𠮦丿ㄋㄋㄋ
拦	扌䒑一一一一
诞	讠丿丨一丨一
饱	饣勹ㄋ一ㄋㄋ
乾	ㄋㄋㄋㄋ
泡	氵勹ㄋ一ㄋㄋ
贼	贝戈一丿丿丿
亭	丁一丨丨丨
夕	夕丿ㄋ丶丶丶
爹	父夕丿ㄋ丶丶
酬	酉川丶丶丶丶
儒	亻一丿丨ㄋ
姻	女因丨ㄋ一丿
卵	丶丿ㄋ丨丶
氛	气分丿丶ㄋ丿
泄	氵廿ㄋㄋㄋㄋ
杆	木干一一丨丨
挨	扌厶丿一一丿
僧	亻曾丶丿丨ㄋ
蜜	宀心丿丨ㄋ一
吟	口今丿丶丶ㄋ
猩	犭日丿一一丨
遂	丷豕丶ㄋ丶丶
狭	犭夹丿丶丶丶
肖	⺝丨ㄋ一一
甜	舌甘一丨丨一
霞	叚ㄋ一丨一
驳	马乂丿丶丶丶
裕	衤八丿丶丨ㄋ
顽	元页一丿丨ㄋ
於	方人丶丶丶丶
摘	扌丨ㄋ一丨
矮	矢禾ㄋ丿一一
秒	禾少丨丿丶丿
卿	丿ㄋ一一ㄋ
畜	亠幺丨ㄋ一丨
咽	口因丨ㄋ一丿
披	扌皮ㄋ丿丨ㄋ
辅	车甫一丨ㄋ一
勾	勹厶ㄋ丶丶丶
盆	分皿丨ㄋ丨丨
疆	弓土一丨ㄋ一
赌	贝者一丨一丿
塑	屰月一丨一一
畏	田一ㄋ丿丶丶
吵	口少丨丿丶丿
囊	吅一一丨丨
嗯	口因丶ㄋ丶丶
泊	氵白丿丨ㄋ一
肺	月一丨ㄋ丨丨
骤	马耳ㄋ丶丿丨
缠	纟广丨ㄋ一一
羞	丑ㄋ丨一一
冈	冂㐅丿丶丶丶
瞪	目癶一丨ㄋ一
吊	口巾丨ㄋ丨丨
贾	覀贝丨ㄋ丿丶
漏	氵尸一丨ㄋ丨
斑	王文一一丨一
涛	氵一丨丶丶
悠	攵丶ㄋ丶丶
鹿	鹿丶一丿ㄋ丨
俘	亻爫ㄋ丨一一
锡	钅日丿ㄋ丿丿
卑	卑丿丨ㄋ一一
葬	艹歹丿ㄋ一丿
铭	钅夕丨ㄋ一一
滩	氵又丿丨丶一
嫁	女宀一丿ㄋ丿
催	亻山丿丨丶一
璇	王族ㄋ丨一丿
翅	十又ㄋ丶一ㄋ
盒	合皿丨ㄋ丨丨
蛮	亦虫丨ㄋ一丨
矣	厶矢丿一一丿
潘	氵釆丨ㄋ一丨
歧	止十ㄋ丶丶丶
赐	贝日丿ㄋ丿丿
锅	钅口丨ㄋ丿丶
鲍	鱼勹ㄋ一ㄋㄋ
廊	广丶ㄋ一一ㄋ
拆	折丶丶丶丶丶
灌	氵艹丨ㄋ一丨
勉	ㄋ丿丿丿
盲	亡目丨ㄋ一一
宰	宀辛丶一丶丿
佐	亻一丨一一
啥	口亼一丨丨ㄋ
胀	月长丿一ㄋ丶
扯	扌止丨一丨一
禧	礻壴丨ㄋ一一
辽	了辶丶ㄋ丶丶
抹	扌未丨丿丶丶
筒	冂一丨ㄋ一
棋	木其一丨丨一
裤	衤广一ㄋ一丨
唉	口厶丿一一丿
朴	木卜丨丶丶丶
咐	口亻一丨丶丶
孕	乃子ㄋ丨一一
誓	折言丶一一一
喉	口亻ㄋ一丿一
妄	亡女ㄋ丿一一
拘	扌勹丨ㄋ一一
链	钅车丶ㄋ丶丶
驰	马也ㄋ丨ㄋㄋ
栏	木䒑一一一一
逝	折辶丶ㄋ丶丶
窃	穴七ㄋ丿丿丿
艳	丰ㄋ丨一ㄋ
臭	自犬一丿丶丶
纤	纟千丿一丨丨
玑	王几丿ㄋㄋㄋ
棵	木日一丨丿丶
趁	走人丿丿丿丿
盈	乃又丨ㄋ丨丨
匠	匚斤丿丿一丨
翁	公羽ㄋ丶一ㄋ
愁	禾火丶ㄋ丶丶
瞬	目丿ㄋ丶一
婴	贝贝ㄋ丿一一
孝	耂子ㄋ丨一一
颈	轻页一丿丨ㄋ
倘	亻丨ㄋ丨ㄋ
浙	氵折一丨一丿
谅	讠京丶一丨ㄋ
蔽	艹㡀丿一丿丶
畅	日丨ㄋ丿丿丿
赠	贝曾丶丿丨ㄋ
妮	女尸丿ㄋㄋㄋ
莎	落少丨丿丶丿
尉	尸示一丨丶丶
冻	冫丨丿丶丶
跪	厃ㄋㄋㄋㄋ
闯	门马ㄋㄋ一一
葡	芍甫一丨ㄋ一
後	彳幺丿丶丿ㄋ
厨	厂豆一丨丶丶
鸭	甲鸟丿ㄋ丶ㄋ
颠	直八一丿丨ㄋ
遮	度灬丶ㄋ丶丶
谊	讠宀丨ㄋ一一
圳	土川丿丨丨丨
吁	口于一一丨丨
仑	仑丿丶丿ㄋㄋ
辟	辟ㄋ一丿丨ㄋ
瘤	疒丨ㄋ一丨
嫂	女臼丨ㄋ丶丶
陀	阝宀丿ㄋㄋㄋ
框	木匚一一丨一
谭	讠覀丨ㄋ一一
亨	了ㄋ丨丨丨
钦	钅欠丿ㄋ丿丶
庸	广肀丿ㄋ一一
歉	兼欠丿ㄋ丿丶
芝	艹之丶ㄋ丶丶
吼	口孑ㄋㄋㄋㄋ
甫	甫一丨ㄋ一一
衫	衤彡丿丿丿丿
宴	宀日ㄋ丿一一
摊	扌又丿丨丶一
嘱	口尸丿丨ㄋ一
衷	亠中丿ㄋ丿丶
娇	女夭丿丨丨丨
陕	阝夹丿丶丶丶
矩	矢匚ㄋ一一一
浦	氵甫一丨ㄋ一
讶	讠牙一ㄋ丨丿
耸	从耳一丨丨一
裸	衤日一丨丿丶
碧	王白一丿丨ㄋ
摧	扌山丿丨丶一
薪	艹立一丨丿丶
淋	氵林一丨丿丶
耻	耳止丨一丨一
胶	月六丿丶丶丶
屠	尸者一丨一丿
鹅	我鸟丿ㄋ丶ㄋ
盼	目分丿丶ㄋ丿
饥	饣几丿ㄋㄋㄋ
脖	月ㄋ丨一一
虹	虫工一丨一一
翠	羽亠丿丶丿丶
崩	山月丿ㄋ一一
账	贝长丿一ㄋ丶
萍	落平一丶丿一
逢	夂丰丶ㄋ丶丶
赚	贝兼丶丿一ㄋ
撑	扌丿一一丨
翔	羽ㄋ丶一ㄋ
绵	纟白丨ㄋ丨丨
倡	亻日丨ㄋ一一
枯	木古一丨丨ㄋ
猴	犭亻ㄋ一丿一
巫	工从丿丶丿丶
昭	日刀丨ㄋ一一
怔	忄正一丨一丨
渊	氵丶丿一丨
凑	冫丿一丿丶
溪	氵爫ㄋㄋ丶一
蠢	日丨ㄋ一丨
禅	礻单丶丿丨ㄋ
阐	门单丶丿丨ㄋ
旺	日王一一丨一
寓	宀日丨ㄋ丨一
藤	艹月丶丿一一
匪	匚非丨一一一
伞	人丷一丨丨丨
碑	石卑丿丨ㄋ一
挪	扌ㄋ丨丨丨
琼	王京丶一丨ㄋ
脂	月匕丨ㄋ一一
谎	讠艹丶一ㄋ丿
慨	忄一ㄋ丿ㄋ
菩	艹立丨ㄋ一一
萄	芍缶丿一一丨
狮	犭一丨ㄋ丨
掘	扌尸ㄋ丨丨ㄋ
抄	扌少丨丿丶丿
岭	山令丿丶丶ㄋ
晕	日冖一ㄋ一丨
砍	石欠丿ㄋ丿丶
逮	氺丶ㄋ丶丶
掏	扌勹丿一一丨
狄	犭火丶丿丿丶
晰	日木丿丿一丨
罕	冖八一一丨丨
挽	扌丿ㄋㄋㄋ
脾	月卑丿丨ㄋ一
舟	舟丿丿ㄋ丶一
痴	疒矢丨ㄋ一一
蔡	艹一一丨丿
剪	前刀ㄋ丿丿丿
脊	人丨ㄋ一一
弓	弓ㄋ一ㄋㄋㄋ
懒	忄束丿ㄋ丨ㄋ
叉	又丶丶丶丶丶
喃	口十丨ㄋ丶丿
拐	扌口ㄋ丿丿丿
僚	亻大丶丿丨ㄋ
捐	扌口丨ㄋ一一
姊	女弟丶丿ㄋ一
骚	马又丶丨ㄋ一
拓	扌石一丿丨ㄋ
歪	不正一丨一丨
粘	米占丨一丨ㄋ
柄	木丙丿丶丶丶
坑	土亠丿ㄋㄋㄋ
陌	阝一丿丨ㄋ一
窄	穴乍丿一丨一
湘	氵相一丨丿丶
兆	儿丶一丿丶
崖	山厂一丨一一
骄	马夭丿丨丨丨
刹	乂朩丨丨丨丨
鞭	革亻一丨ㄋ一
芒	艹亡丶一ㄋㄋ
筋	月ㄋ丿丿丿
聘	耳由一ㄋㄋㄋ
棍	木日一ㄋ丿ㄋ
钩	钅勹ㄋ丶丶丶
嚷	口亠丨ㄋ一丨
腺	月白丨ㄋ丿丶
弦	弓亠ㄋㄋ丶丶
焰	火丿丨一ㄋ
耍	而女ㄋ丿一一
俯	亻广丿丶一丨
厘	厂里丨ㄋ一一
愣	忄罒丶一ㄋ丿
厦	厂丆丨ㄋ一一
恳	艮心丶ㄋ丶丶
饶	饣尧一ㄋ丿一
钉	钅丁一丨丨丨
寡	宀丆丨ㄋ一一
憾	忄戊一丨ㄋ一
摔	扌亠ㄋㄋ丶丶
叠	又双丶ㄋ丨ㄋ
惹	艹丨ㄋ一丶
喻	口亼丨ㄋ一一
谱	讠䒑丨丨丶丿
愧	忄鬼丿丨ㄋ一
煌	火白一一丨一
徽	糸ㄋㄋ丶丨
溶	氵穴丿丶丨ㄋ
坠	阝人一丨一一
煞	刍攵丶丶丶丶
巾	巾丨ㄋ丨丨丨
滥	氵丨ㄋ丨丨
洒	氵西一丨ㄋ丿
堵	土者一丨一丿
瓷	次瓦一ㄋㄋ丶
咒	吅几丿ㄋㄋㄋ
姨	女大ㄋ一ㄋㄋ
棒	木一一丨丨
郡	尹口ㄋ丨丨丨
浴	氵八丿丶丨ㄋ
媚	女丨ㄋ一一
稣	鱼禾丿一丨丿
淮	氵隹丿丨丶一
哎	口艹丿丶丶丶
屁	尸比一ㄋ丿ㄋ
漆	氵木丿丶丶丶
淫	氵爫丿一丨一
巢	巛日一丨丿丶
吩	口分丿丶ㄋ丿
撰	扌巳ㄋ一ㄋ一
啸	口肀丿丨丿丶
滞	氵丶ㄋ丨ㄋ
玫	王攵丿一丿丶
硕	石页一丿丨ㄋ
钓	钅勹丶丶丶丶
蝶	虫廿ㄋ一丨丿
膝	月木丿丶丨丶
姚	女儿丶一丿丶
茂	艹戊一丿ㄋ丿
躯	身匚丿丶丶丶
吏	乂丿丶丶丶
猿	犭吉丿ㄋ丿丶
寨	寒朩一丨丿丶
恕	女口丶ㄋ丶丶
渠	氵匚ㄋ一一丨
戚	戊上丨丿丶丶
辰	辰一丿一一ㄋ
舶	舟白丿丨ㄋ一
颁	分页一丿丨ㄋ
惶	忄白一一丨一
狐	犭瓜丿丿ㄋ丶
讽	讠几丿丶丶丶
笨	木一一一一
袍	衤勹ㄋ一ㄋㄋ
嘲	口丿ㄋ一一
啡	口非丨一一一
泼	氵发ㄋ丿ㄋ丶
衔	彳钅一一丨丨
倦	亻ㄋㄋㄋㄋ
涵	氵了丶一丿丶
雀	小隹丿丨丶一
旬	勹日丨ㄋ一一
僵	亻一丨ㄋ一丨
撕	扌其丿丿一丨
肢	月十ㄋ丶丶丶
垄	龙土一丨一一
逸	丶丶ㄋ丶
夷	大弓ㄋ一ㄋㄋ
茅	艹矛ㄋ丶ㄋ丨
侨	亻夭丿丨丨丨
舆	车一丿丶丶
窑	穴缶丿一一丨
涅	氵日一丨一一
蒲	落甫一丨ㄋ一
谦	讠兼丶丿一ㄋ
杭	木亠丿ㄋㄋㄋ
噢	口丶丿一丨
弊	㡀攵一丿丨丨
勋	口贝ㄋ丿丿丿
刮	舌刂丨丨丨丨
郊	六乂ㄋ丨丨丨
凄	冫一ㄋ一一丨
捧	扌一一丨丨
浸	氵彐丶ㄋㄋ丶
砖	石二ㄋ丶丶丶
鼎	目丨一丨ㄋ
篮	丨ㄋ丨丨
蒸	艹了ㄋ丿丶一
饼	饣䒑一丿丨丨
亩	亠田丨ㄋ一丨
肾	⺝丨ㄋ一一
陡	阝走一丨一丨
爪	爪丿丿丨丶丶
兔	丶丶丶丶
殷	彐ㄋ丿ㄋㄋ
贞	⺊贝丨ㄋ丿丶
哑	口亚一丨丨丶
荐	艹ㄋ丨一一
炭	山丶丿丿丶
坟	土文丶一丿丶
眨	目丿丶ㄋ丶丶
搏	扌甫一丨丶丶
咳	口亥丶一ㄋ丿
拢	扌龙一丿ㄋ丿
舅	臼田ㄋ丿丿丿
昧	日未丨丿丶丶
擅	扌亠丨ㄋ丨ㄋ
爽	大乂丿丶丿丶
咖	口加ㄋ丿丨ㄋ
搁	扌门丿ㄋ丶丨
禄	礻丨ㄋ丿丶
雌	此隹丿丨丶一
哨	口丨ㄋ一一
巩	工几丶丶丶丶
绢	纟口丨ㄋ一一
螺	虫田ㄋㄋ丶丨
裹	亠日一丨丿丶
昔	龷日丨ㄋ一一
轩	车干一一丨丨
谬	讠羽丿丶丿丿
谍	讠廿ㄋ一丨丿
龟	日ㄋㄋㄋㄋ
媳	女自丶ㄋ丶丶
姜	女ㄋ丿一一
瞎	目宀一一一丨
冤	冖丿ㄋ丶丶
鸦	牙鸟丿ㄋ丶ㄋ
蓬	艹夂一一一丨
巷	共巳ㄋ一ㄋㄋ
琳	王林一丨丿丶
栽	木一丨丿丶
沾	氵占丨一丨ㄋ
诈	讠乍丿一丨一
斋	文而一丿丨ㄋ
瞒	目艹一丨ㄋ丿
彪	虍几丿丿丿丿
厄	厂ㄋㄋㄋㄋ
咨	次口丨ㄋ一一
纺	纟方丶一ㄋ丿
罐	缶艹丨ㄋ一丨
桶	木甬ㄋ丶丨ㄋ
壤	土亠丨ㄋ一丨
糕	米羊丶丶丶丶
颂	公页一丿丨ㄋ
膨	月壴丿丿丿丿
谐	讠比丿丨ㄋ一
垒	厶厶ㄋ丶一丨
咕	口古一丨丨ㄋ
隙	阝小丨ㄋ一一
辣	辛束一丨ㄋ一
绑	纟ㄋ丨丨丨
宠	宀龙一丿ㄋ丿
嘿	口黑丨ㄋ丶丿
兑	𠮦儿丿ㄋㄋㄋ
霉	ㄋㄋ丶一
挫	扌从一丨一一
稽	禾尢丶丿ㄋ丨
辐	车丨ㄋ一丨
乞	乙ㄋㄋㄋㄋ
纱	纟少丨丿丶丿
裙	衤尹丨ㄋ一一
嘻	口壴丨ㄋ一一
哇	口圭一丨一一
绣	纟禾ㄋ丿丿丿
杖	木丶丶丶丶
塘	土广ㄋ一一丨
衍	彳氵一一丨丨
轴	车由丨ㄋ一丨
攀	木乂丿丶一丨
膊	月甫一丨丶丶
譬	辟言丶一一一
斌	文一一ㄋ丶丨
祈	礻斤丿丿一丨
踢	日丿ㄋ丿丿
肆	镸聿ㄋ一一一
坎	土欠丿ㄋ丿丶
轿	车夭丿丨丨丨
泣	氵立丶一丶丿
棚	木月丿ㄋ一一
屡	尸米ㄋ丿一一
躁	口丨ㄋ一丨
邱	丘阝ㄋ丨丨丨
凰	几白一一丨一
溢	氵䒑丿丶丨ㄋ
椎	木隹丿丨丶一
砸	石匚丨ㄋ丨丨
趟	走丨ㄋ丨ㄋ
帘	穴巾丨ㄋ丨丨
帆	巾几丶丶丶丶
栖	木西一丨ㄋ丿
窜	穴口丨ㄋ一丨
丸	九丶丶丶丶丶
斩	车斤丿丿一丨
堤	土是丨ㄋ一一
塌	土日ㄋ丶一ㄋ
厢	厂相一丨丿丶
贩	贝ㄋ丶丶丶
掀	折欠丿ㄋ丿丶
喀	口宀丿ㄋ丶丶
乖	千北丨一一丿
谜	讠米丶ㄋ丶丶
捏	扌日一丨一一
阎	门丿丨一ㄋ
滨	氵宀丿丨一丨
虏	虍力ㄋ丿丿丿
匙	是匕丿ㄋㄋㄋ
芦	艹户丶ㄋ一丿
苹	艹平一丶丿一
卸	止ㄋ丨丨丨
沼	氵刀丨ㄋ一一
钥	钅月丿ㄋ一一
株	木丿丨丿丶丶
祷	衤一丨丶丶
剖	立口丨丨丨丨
熙	巳丶丶丶丶
劈	辟刀ㄋ丿丿丿
怯	忄去一丨一ㄋ
哗	口化一丨丨丨
棠	木一丨丿丶
胳	月各丿ㄋ丶丨
桩	木广一丨一一
瑰	王鬼丿丨ㄋ一
娱	女口一一丿丶
娶	耳又ㄋ丿一一
沫	氵未丨丿丶丶
嗓	口又ㄋ丶ㄋ丶
蹲	酋一丨丶丶
焚	林火丶丿丿丶
淘	氵勹丿一一丨
嫩	女束丿一丿丶
韵	音勹丶一一一
衬	衤寸一丨丶丶
匈	勹乂ㄋ丨丨丨
竖	立丶一丶丿
钧	钅勹丶一一一
峻	山厶丿丶丿ㄋ
豹	豸勹丶丶丶丶
捞	扌ㄋ丿丿丿
菊	芍米丶丿一丨
鄙	口十丨ㄋ丨ㄋ
魄	白鬼丿丨ㄋ一
兜	白ㄋ一丿ㄋ
哄	口共一丨丨一
颖	匕禾一丿丨ㄋ
镑	钅丶一ㄋ丿
屑	尸丨ㄋ一一
蚁	虫义丶丿丶丶
壶	业丨丨丶丿
怡	忄厶丨ㄋ一一
渗	氵丿丿丿丿
秃	禾几丿ㄋㄋㄋ
迦	加辶丶ㄋ丶丶
旱	日干一一丨丨
哟	口纟丿ㄋ丶丶
咸	戊一丨ㄋ一
焉	正与丶丶丶丶
宛	宀夕ㄋㄋㄋㄋ
谴	讠丨ㄋ一ㄋ
稻	禾爫丿丨一ㄋ
铸	钅一丨丶丶
伽	亻加ㄋ丿丨ㄋ
锻	钅段丿丨一一
詹	厃八丶一一一
毙	比歹丿ㄋㄋㄋ
恍	忄光丨丶丿一
贬	贝丿丶ㄋ丶丶
烛	火虫丨ㄋ一丨
骇	马亥丶一ㄋ丿
芯	艹心丶ㄋ丶丶
汁	氵十一丨丨丨
桓	木一丨ㄋ一一
坊	土方丶一ㄋ丿
驴	马户丶ㄋ一丿
朽	木丂一ㄋㄋㄋ
靖	立青一一丨一
佣	亻用丿ㄋ一一
汝	氵女ㄋ丿一一
碌	石丨ㄋ丿丶
迄	乙丶ㄋ丶丶
冀	北田一丨丨一
荆	艹开丨丨丨丨
崔	山隹丿丨丶一
雁	厂亻丿丨丶一
绅	纟日丨丨丨丨
珊	王冂丿ㄋ一一
榜	木丶一ㄋ丿
诵	讠甬ㄋ丶丨ㄋ
傍	亻丶一ㄋ丿
彦	厂丿丿丿丿
醇	酉ㄋ丨一一
笛	由丨ㄋ一丨
禽	人㐫丨ㄋㄋ丶
勿	勿丿ㄋ丿丿丿
娟	女口丨ㄋ一一
瞄	目艹丨ㄋ一丨
幢	巾立丨ㄋ一一
寇	宀元丨一ㄋ丶
睹	目者一丨一丿
贿	贝丨ㄋ一一
踩	爫一丨丿丶
霆	壬ㄋ丶丶丶
呜	口勹ㄋ一一一
拱	扌共一丨丨一
妃	女己ㄋ一ㄋㄋ
蔑	萝戊丶丶丶丶
谕	讠亼丨ㄋ一一
缚	纟甫一丨丶丶
诡	讠厃ㄋㄋㄋㄋ
篷	夂一一一丨
淹	氵大丨ㄋ一一
腕	月宀丿ㄋ丶ㄋ
煮	者灬丶丶丶丶
倩	亻青一一丨一
卒	亠从一丨丨丨
勘	其乚ㄋ丿丿丿
馨	士丿ㄋㄋ丶
逗	豆辶丶ㄋ丶丶
贱	贝戋一一ㄋ丿
甸	勹田丨ㄋ一丨
炒	火少丨丿丶丿
灿	火山丨ㄋ丨丨
敞	冂丨ㄋ一丿
蜡	虫龷丨ㄋ一一
囚	囗人丿丶丶丶
栗	覀木一丨丿丶
辜	古辛丶一丶丿
垫	执土一丨一一
妒	女户丶ㄋ一丿
魁	鬼⺀一丨丨丨
谣	讠爫丿一一丨
寞	宀莫一丨丨丨
甩	月乚ㄋㄋㄋㄋ
蜀	罒勹丨ㄋ一丨
枕	木冖丿ㄋㄋㄋ
涯	氵厂一丨一一
丐	一⺊ㄋㄋㄋㄋ
泳	氵丶ㄋㄋ丿丶
奎	大圭一丨一一
泌	氵心丿丿丿丿
逾	亼⺝丨丨丶ㄋ
叮	口丁一丨丨丨
黛	代黑丨ㄋ丶丿
燥	火口丨ㄋ一丨
掷	扌䒑一丿丶ㄋ
藉	艹耒一丨丨一
憎	忄曾丶丿丨ㄋ
枢	木区一丿丶ㄋ
鲸	鱼京丶一丨ㄋ
弘	弓厶ㄋ丶丶丶
倚	亻大一丨ㄋ一
侮	亻ㄋㄋ丶一
藩	落釆丨ㄋ一丨
拂	扌弓丿丨丨丨
鹤	冖隹丿ㄋ丶ㄋ
蚀	饣虫丨ㄋ一丨
芙	艹夫一一丿丶
浆	丬夕丨ㄋ丿丶
垃	土立丶一丶丿
烤	火耂一ㄋㄋㄋ
晒	日西一丨ㄋ丿
霜	相一丨丿丶
剿	巛日一丨丿丶
蕴	艹纟丨ㄋ一一
圾	土及丿ㄋ丶丶
绸	纟冂一丨一丨
屿	山与一一一一
氢	气轻ㄋ丶一丨
驼	马宀丿ㄋㄋㄋ
妆	丬女ㄋ丿一一
捆	扌囗一丨丿丶
铅	钅几丨ㄋ一一
逛	犭王丶ㄋ丶丶
淑	氵上丨丿丶ㄋ
榴	木丨ㄋ一丨
痒	疒羊丶丿一一
丙	丙人丿丶丶丶
钞	钅少丨丿丶丿
蹄	丨ㄋ丨丨
犬	犬一丿丶丶丶
躬	身弓ㄋ一ㄋㄋ
昼	尺旦丨ㄋ一一
藻	落口丨ㄋ一丨
蛛	虫丿丨丿丶丶
褐	衤日丿ㄋ丿丶
颊	夹人一丿丨ㄋ
奠	酋大一丿丶丶
募	莫力ㄋ丿丿丿
耽	耳冖丿ㄋㄋㄋ
蹈	爫丿丨一ㄋ
陋	阝丙丿丶ㄋㄋ
侣	亻口丨ㄋ一一
魅	鬼未丨丿丶丶
岚	山几丿丶丶丶
侄	亻至一ㄋ丶一
虐	虍一ㄋ一一
堕	阝丨ㄋ一一
陛	阝比一丨一一
莹	王丶丶丶丶
荫	艹阝丿ㄋ一一
狡	犭六丿丶丶丶
阀	门亻一ㄋ丿丶
绞	纟六丿丶丶丶
膏	口丨ㄋ一一
垮	土大一一ㄋㄋ
茎	艹轻ㄋ丶一丨
缅	纟面一丿丨ㄋ
喇	口束丨丨丨丨
绒	纟戈一丿丿丿
搅	扌丨ㄋ丿ㄋ
凳	癶豆丿ㄋㄋㄋ
梭	木厶丿丶丿ㄋ
丫	丷丨丨丨丨丨
姬	女一丨丨ㄋ
诏	讠刀丨ㄋ一一
钮	钅丑ㄋ丨一一
棺	木宀丨ㄋ一ㄋ
耿	耳火丶丿丿丶
缔	纟丨ㄋ丨丨
懈	忄角ㄋ丿丿一
嫉	女疒丿一一丿
灶	火土一丨一一
匀	勹冫丶一一一
嗣	口ㄋ一丨ㄋ
鸽	合鸟丿ㄋ丶ㄋ
澡	氵口丨ㄋ一丨
凿	业ㄋ丨丨丨
纬	纟韦一一ㄋ丨
沸	氵弓丿丨丨丨
刃	刀丶丶丶丶丶
畴	田一丨丶丶
遏	日勹丿丶ㄋ丶
烁	火丨丿丶丶
嗅	口自一丿丶丶
叭	口八丿丶丶丶
熬	敖灬丶丶丶丶
瞥	㡀攵丨ㄋ一一
骸	骨亥丶一ㄋ丿
奢	大者一丨一丿
拙	扌屮ㄋ丨丨丨
栋	木丨丿丶丶
毯	毛火丶丿丿丶
桐	木冂一丨ㄋ一
砂	石少丨丿丶丿
莽	艹犬一丿丨丨
泻	氵冖ㄋ一一一
坪	土平一丶丿一
梳	木丿丨ㄋㄋ
杉	木彡丿丿丿丿
晤	日五丨ㄋ一一
稚	禾隹丿丨丶一
蔬	艹乛丨一丨一
蝇	虫口丨ㄋ一一
捣	扌丨ㄋ丨丨
顷	页一丿丨ㄋ
麽	麻丿ㄋ丶丶丶
尴	尢丨ㄋ丨丨
镖	钅覀一一丨丿
诧	讠宀丿一ㄋㄋ
尬	尢人丿丨丨丨
硫	石丿丨ㄋㄋ
羡	次丶一丿ㄋ
嚼	口爫丨ㄋ丨丨
沦	氵仑丿丶丿ㄋ
沪	氵户丶ㄋ一丿
旷	日广丶一丿丿
彬	林彡丿丿丿丿
芽	艹牙一ㄋ丨丿
冥	冖日丶一丿丶
狸	犭里丨ㄋ一一
碳	石山一丿丶丿
咧	口歹丨丨丨丨
惕	忄日丿ㄋ丿丿
暑	日者一丨一丿
咯	口各丿ㄋ丶丨
萝	萝夕丿ㄋ丶丶
汹	氵乂ㄋ丨丨丨
腥	月日丿一一丨
窥	穴夫丨ㄋ丿ㄋ
俺	亻大丨ㄋ一一
潭	氵覀丨ㄋ一一
崎	山大一丨ㄋ一
麟	鹿米丿ㄋ丶一
捡	扌亼丶丶丿一
厥	厂屰丿ㄋ丿丶
拯	扌了ㄋ丿丶一
澄	氵癶一丨ㄋ一
哉	口丨ㄋ一一
萎	艹禾ㄋ丿一一
涡	氵口丨ㄋ丿丶
滔	氵爫丿丨一ㄋ
暇	日叚ㄋ一丨一
溯	氵屰丿ㄋ一一
鳞	鱼米丿ㄋ丶一
酿	酉丶ㄋ一一ㄋ
愕	忄吅一一ㄋㄋ
茵	艹因丨ㄋ一丿
暮	莫日丨ㄋ一一
瞅	目禾丶丿丿丶
衙	彳五丨ㄋ一一
诫	讠戈一丿丨丨
斧	父斤丿丿一丨
兮	八丂一ㄋㄋㄋ
焕	火丨ㄋ一丿
棕	木宀一一丨丿
佑	亻丨ㄋ一一
嘶	口其丿丿一丨
妓	女十ㄋ丶丶丶
喧	口宀一丨ㄋ一
蓉	艹穴丿丶丨ㄋ
删	冂冂一丨丨丨
樱	木贝丨ㄋ丿丶
伺	亻一丨ㄋ一
嗡	口公ㄋ丶一ㄋ
娥	女我丿一丨一
梢	木丨ㄋ一一
坝	土贝丨ㄋ丿丶
蚕	天虫丨ㄋ一丨
敷	甫方丿一丿丶
澜	氵门一丨ㄋ一
杏	木口丨ㄋ一一
绥	纟爫ㄋ丿一一
冶	冫厶丨ㄋ一一
挠	扌尧一ㄋ丿一
庇	广比一ㄋ丿ㄋ
搂	扌米ㄋ丿一一
倏	夂一丿丶丶
婉	女宀丿ㄋ丶ㄋ
聂	耳双ㄋ丶ㄋ丶
噪	口口丨ㄋ一丨
稼	禾宀一丿ㄋ丿
鳍	鱼耂丿ㄋ丨ㄋ
菱	艹土丿丶丿ㄋ
盏	戋皿丨ㄋ丨丨
匿	匚艹一丿丨ㄋ
吱	口十ㄋ丶丶丶
寝	宀丬ㄋ一一ㄋ
揽	扌丨ㄋ丿ㄋ
髓	骨一丨一丶
秉	禾彐ㄋ一一一
矢	矢丿一一丿丶
哺	口甫一丨ㄋ一
啪	口扌丿丨ㄋ一
帜	巾口丿丶丶丶
邵	刀口ㄋ丨丨丨
挟	扌夹丿丶丶丶
嗽	口束丿ㄋ丿丶
缸	缶工一丨一一
揉	扌矛一丨丿丶
腻	月弋一一丨ㄋ
驯	马川丿丨丨丨
缆	纟丨ㄋ丿ㄋ
晌	日丨ㄋ一一
瘫	疒又丿丨丶一
贮	贝宀一一一一
觅	爫见丨ㄋ丿ㄋ
朦	月一一丿ㄋ
僻	亻辟ㄋ一丿丨
隋	阝一丨一丨
蔓	艹日丨ㄋ丨丨
咋	口乍丿一丨一
嵌	山甘丿ㄋ丿丶
虔	虍文丶一丿丶
畔	田半丶丿一一
琐	王丨ㄋ丿丶
碟	石廿ㄋ一丨丿
涩	氵刀丶丨一丨
胧	月龙一丿ㄋ丿
嘟	口者ㄋ丨丨丨
蹦	山丿ㄋ一一
冢	冖豕丶丶丶丶
浏	氵文丨丨丨丨
裔	衣冂丿丶丨ㄋ
襟	礻林一一丨丿
叨	口刀ㄋ丿丿丿
诀	讠丿丶丶丶
旭	九日丨ㄋ一一
虾	虫下一丨丶丶
簿	氵一丨ㄋ一
啤	口卑丿丨ㄋ一
擒	扌人丶一丿丶
枣	朿⺀丶丶丶丶
嘎	口丆丨ㄋ一一
苑	艹夕ㄋㄋㄋㄋ
牟	厶牛丿一一丨
呕	口区一丿丶ㄋ
骆	马各丿ㄋ丶丨
凸	凸丨一丨ㄋ一
熄	火自丶ㄋ丶丶
兀	一儿丿ㄋㄋㄋ
喔	口尸一ㄋ丶一
裳	衣丶一丿ㄋ
凹	凹丨ㄋ丨ㄋ一
赎	贝十ㄋ丶丶一
屯	屯一ㄋ丨ㄋㄋ
膛	月一丨一一
浇	氵尧一ㄋ丿一
灼	火勹丶丶丶丶
裘	求衣丶一丿ㄋ
砰	石平一丶丿一
棘	朿朿一丨ㄋ丨
橡	木象丿ㄋ丨ㄋ
聋	龙耳一丨丨一
碱	石戊一丨ㄋ一
姥	女耂丿ㄋㄋㄋ
瑜	王亼丨ㄋ一一
毋	毋ㄋㄋ丿一一
娅	女亚一丨丨丶
俏	亻丨ㄋ一一
沮	氵且丨ㄋ一一
萌	艹日丿ㄋ一一
黯	黑音丶一丶丿
撇	扌㡀丿一丿丶
粟	覀米丶丿一丨
尹	尹ㄋ一一丿丿
粪	米共一丨丨一
苟	芍口丨ㄋ一一
癫	疒直丿丶一丿
蚂	虫马ㄋㄋ一一
禹	丿口丨ㄋ丨一
廖	广羽丿丶丿丿
俭	亻亼丶丶丿一
帖	巾占丨一丨ㄋ
煎	前灬丶丶丶丶
缕	纟米ㄋ丿一一
窦	穴十ㄋ丶丶一
簇	族丿一一丿
棱	木土丿丶丿ㄋ
叩	口卩ㄋ丨丨丨
呐	口内丨ㄋ丿丶
瑶	王爫丿一一丨
墅	里予一丨一一
莺	鸟丿ㄋ丶ㄋ
烫	氵㇡丿丿丶丿
蛙	虫圭一丨一一
歹	歹一丿ㄋ丶丶
伶	亻令丿丶丶ㄋ
葱	艹勿丶丶ㄋ丶
哮	口耂ㄋ丨一一
眩	目亠ㄋㄋ丶丶
坤	土日丨丨丨丨
廓	广ㄋ丨一ㄋ
讳	讠韦一一ㄋ丨
啼	口丨ㄋ丨丨
乍	乍丿一丨一一
瓣	辛瓜丶一丶丿
矫	矢夭丿丨丨丨
枉	木王一一丨一
跋	ㄋ丶丶丶
梗	木更一丨ㄋ一
厕	厂贝丨丨丨丨
琢	王豕丶丶丶丶
讥	讠几丿ㄋㄋㄋ
釉	釆由丨ㄋ一丨
窟	穴尸ㄋ丨丨ㄋ
敛	亼丿一丿丶
轼	车弋一丨一一
庐	广户丶ㄋ一丿
胚	月不一一一一
呻	口日丨丨丨丨
绰	纟⺊丨ㄋ一一
扼	扌厂ㄋㄋㄋㄋ
懿	豆丶一丿ㄋ
炯	火冂丨ㄋ一一
竿	干一一丨丨
慷	忄广ㄋ一一丨
虞	虍口一一丿丶
锤	钅垂丿一丨一
栓	木人一一丨一
桨	丬夕一丨丿丶
蚊	虫文丶一丿丶
磅	石丶一ㄋ丿
孽	艹丿丨ㄋ一ㄋ
惭	忄车丿丿一丨
戳	羽隹一ㄋ丿丶
禀	亠回一一丨丿
鄂	吅二ㄋㄋ丨丨
馈	饣丨ㄋ丿丶
垣	土一丨ㄋ一一
溅	氵贝一一ㄋ丿
咚	口夂丶丶丶丶
礁	石隹丶丶丶丶
钙	钅一丨一ㄋㄋ
彰	音十丿丿丿丿
眯	目米丶丿一丨
豁	宀丰丨ㄋ一丿
雯	文丶一丿丶
磷	石米丿ㄋ丶一
墟	土虍丨丨丶丿
迂	于辶丶ㄋ丶丶
瞻	目厃丿丶丶一
颅	⺊尸一丿丨ㄋ
琉	王丿丨ㄋㄋ
悼	忄⺊丨ㄋ一一
蝴	虫古丿ㄋ一一
拣	扌ㄋ丿丶丶
渺	氵目丨丿丶丿
眷	目丨ㄋ一一
悯	忄门丶一丿丶
汰	氵大丶丶丶丶
慑	忄耳ㄋ丶ㄋ丶
婶	女宀丨ㄋ一一
斐	非文丶一丿丶
嘘	口虍丨丨丶丿
镶	钅亠丨ㄋ一丨
炕	火亠丿ㄋㄋㄋ
宦	宀臣一丨ㄋ一
趴	八丿丶丶丶
绷	纟月丿ㄋ一一
窘	穴尹丨ㄋ一一
襄	亠吅一一丨丨
珀	王白丿丨ㄋ一
嚣	吅页丨ㄋ一丨
拚	扌厶一丿丨丨
酌	酉勹丶丶丶丶
浊	氵虫丨ㄋ一丨
毓	母丶一ㄋ丶
撼	扌戊一丨ㄋ一
嗜	口耂丿ㄋ丨ㄋ
扛	扌工一丨一一
峭	山丨ㄋ一一
磕	石去丨ㄋ丨丨
翘	尧羽ㄋ丶一ㄋ
槽	木一丨ㄋ一丨
栅	木冂丨ㄋ一一
淌	氵丨ㄋ丨ㄋ
颓	禾几一丿丨ㄋ
熏	千黑丨ㄋ丶丿
瑛	王艹丨ㄋ一丿
忖	忄寸一丨丶丶
颐	页一丿丨ㄋ
牡	牜土一丨一一
缀	纟双ㄋ丶ㄋ丶
徊	彳回丨ㄋ丨ㄋ
梨	禾刂一丨丿丶
肪	月方丶一ㄋ丿
涕	氵弟丶丿ㄋ一
惫	夂田丶ㄋ丶丶
摹	莫手丿一一丨
踱	度ㄋ丶丶丶
肘	月寸一丨丶丶
挚	执手丿一一丨
熔	火穴丿丶丨ㄋ
氯	气丨ㄋ丿丶
凛	冫亠丨ㄋ丨ㄋ
绎	纟又一一丨丨
庶	度灬丶丶丶丶
脯	月甫一丨ㄋ一
迭	丿夫丶ㄋ丶丶
睦	目土丿丶一丨
窍	穴工一ㄋㄋㄋ
粥	弓米ㄋ一ㄋㄋ
庵	广大丨ㄋ一一
沧	氵人ㄋㄋㄋㄋ
沁	氵心丶ㄋ丶丶
奕	亦大一丿丶丶
怠	厶口丶ㄋ丶丶
咙	口龙一丿ㄋ丿
氨	气宀ㄋ丿一一
矗	直直一丨丨ㄋ
盔	火丨ㄋ丨丨
拇	扌母ㄋㄋ丶一
沛	氵一丨ㄋ丨丨
榻	木日ㄋ丶一ㄋ
揣	扌山一丿丨ㄋ
崭	山车丿丿一丨
鞘	革丨ㄋ一一
鞠	革勹丶丿一丨
垦	艮土一丨一一
唾	口垂丿一丨一
洽	氵合丿丶一丨
橱	木厂一丨ㄋ一
仕	亻士一丨一一
蜘	虫矢丨ㄋ一一
痰	疒火丶丿丿丶
袜	衤未丨丿丶丶
峙	山土一丨丶丶
柬	束丷丶丶丶丶
蝉	虫单丶丿丨ㄋ
蟹	角刀丿一一丨
谏	讠束丶丶丶丶
擎	芍口丿一丿丶
鹃	口⺝丿ㄋ丶ㄋ
皓	白告丿一丨一
朕	月䒑一丿丶丶
疤	疒巴ㄋ丨一ㄋ
禺	日⽱丨ㄋ丨一
铲	钅一丿丿丿
酶	酉ㄋㄋ丶一
钝	钅屯一ㄋ丨ㄋ
氓	亡民ㄋ一ㄋ一
匣	匚甲丨ㄋ一一
弧	弓瓜丿丿ㄋ丶
峨	山我丿一丨一
锥	钅隹丿丨丶一
揪	扌禾丶丿丿丶
杠	木工一丨一一
吭	口亠丿ㄋㄋㄋ
崛	山尸ㄋ丨丨ㄋ
诬	讠工丿丶丿丶
冉	冂土一丨一一
抒	扌予ㄋ丶ㄋ丨
庚	广彐丿丶丶丶
悍	忄日一一丨丨
靡	麻非丨一一一
晦	日ㄋㄋ丶一
醋	酉龷丨ㄋ一一
夭	夭丿一丿丶丶
锯	钅尸一丨丨ㄋ
壕	土一丿ㄋ丿
咦	口大ㄋ一ㄋㄋ
侈	亻夕丿ㄋ丶丶
婢	女卑丿丨ㄋ一
猾	犭骨丨ㄋㄋ丶
徘	彳非丨一一一
硝	石丨ㄋ一一
煽	火户ㄋ丶一ㄋ
皂	白七一ㄋㄋㄋ
嗦	口ㄋㄋ丶丨
舵	舟宀丿ㄋㄋㄋ
靴	革化丿丨丿ㄋ
狈	犭贝丨ㄋ丿丶
捂	扌五丨ㄋ一一
郝	赤阝ㄋ丨丨丨
疮	疒人ㄋㄋㄋㄋ
苛	艹可一丨ㄋ一
秽	禾山丿ㄋ丶丶
茜	艹西一丨ㄋ丿
搓	扌一丨一一
芸	艹云一一ㄋ丶
酱	丬夕一丨ㄋ丿
赁	亻壬丨ㄋ丿丶
檐	木厃丿丶丶一
饷	饣丨ㄋ一一
蕉	艹隹丶丶丶丶
铀	钅由丨ㄋ一丨
苔	艹厶丨ㄋ一一
赦	赤攵丿一丿丶
缎	纟段丿丨一一
舷	舟亠ㄋㄋ丶丶
筷	忄ㄋ一丿丶
朔	屰月丿ㄋ一一
婪	林女ㄋ丿一一
紊	文糸ㄋㄋ丶丨
厮	厂其丿丿一丨
婿	女疋丨ㄋ一一
寥	宀羽丿丶丿丿
兢	古儿一丨丨ㄋ
糙	米告丶ㄋ丶丶
卦	圭卜丨丶丶丶
槐	木鬼丿丨ㄋ一
扒	扌八丿丶丶丶
裴	非衣丶一丿ㄋ
祀	礻巳ㄋ一ㄋㄋ
埔	土甫一丨ㄋ一
絮	女口ㄋㄋ丶丨
芭	艹巴ㄋ丨一ㄋ
屉	尸廿ㄋㄋㄋㄋ
霄	丨ㄋ一一
痪	疒丨ㄋ一丿
绽	纟定丶丶ㄋ一
宵	宀丨ㄋ一一
邑	口巴ㄋ丨一ㄋ
霖	林一丨丿丶
岔	分山丨ㄋ丨丨
茄	艹加ㄋ丿丨ㄋ
饵	饣耳一丨丨一
韧	韦刀丶丶丶丶
琪	王其一丨丨一
邹	刍阝ㄋ丨丨丨
瑚	王古丿ㄋ一一
憋	㡀攵丶ㄋ丶丶
殆	歹厶丨ㄋ一一
噜	口鱼丨ㄋ一一
忒	弋心丶ㄋ丶丶
忿	分心丶ㄋ丶丶
衅	丿皿丶丿一一
淳	氵ㄋ丨一一
悖	忄ㄋ丨一一
髦	髟毛丿一一ㄋ
孜	孑攵丿一丿丶
粤	米一ㄋㄋㄋ
隘	阝䒑丿丶丨ㄋ
濒	氵止丨丿丿一
铮	钅争丿ㄋㄋ一
畸	田大一丨ㄋ一
剔	日勿丨丨丨丨
坞	土勹ㄋ一一一
篱	㐫丨ㄋㄋ丶
淀	氵定丶丶ㄋ一
蓦	莫马ㄋㄋ一一
唬	口虍丿ㄋㄋㄋ
锣	钅罒丿ㄋ丶丶
汀	氵丁一丨丨丨
趾	止丨一丨一
缉	纟口一丨丨一
嫦	女丨ㄋ丨丨
斟	其乚丶丶一丨
鞍	革宀ㄋ丿一一
扳	扌ㄋ丶丶丶
拴	扌人一一丨一
诅	讠且丨ㄋ一一
谟	讠莫一丨丨丨
呃	口厂ㄋㄋㄋㄋ
懦	忄一丿丨ㄋ
逞	口王丶ㄋ丶丶
忏	忄千丿一丨丨
犁	禾刂丿一一丨
拧	扌宀一丨丨丨
叱	口七一ㄋㄋㄋ
佟	亻夂丶丶丶丶
亥	亥丶一ㄋ丿丿
舜	夕一ㄋ丨丨
龚	龙共一丨丨一
绊	纟半丶丿一一
腮	月田丶ㄋ丶丶
邸	氏丶ㄋ丨丨丨
蔚	艹尸一一丨丿
椒	木上丨丿丶ㄋ
湛	氵其ㄋㄋㄋㄋ
狩	犭宀一丨丶丶
眶	目匚一一丨一
栈	木戋一一ㄋ丿
薇	艹丿ㄋㄋㄋ
肮	月亠丿ㄋㄋㄋ
瀑	氵日一丨丨一
渣	氵木丨ㄋ一一
褂	衤圭丨丶丶丶
叽	口几丿ㄋㄋㄋ
臀	尸共丨ㄋ一一
妞	女丑ㄋ丨一一
巍	山禾ㄋ丿一丿
唔	口五丨ㄋ一一
疚	疒久丿ㄋ丶丶
戎	戈一丿丿丿
鲤	鱼里丨ㄋ一一
肇	户攵ㄋ一一一
笃	马ㄋㄋ一一
娴	女门一丨丿丶
辙	车丨ㄋ一一
阮	阝元一一丿ㄋ
札	木乚ㄋㄋㄋㄋ
懊	忄丶丿一丨
焘	寸丶丶丶丶
恤	忄丿丨ㄋ丨丨
疹	疒人丿丿丿丿
潇	氵艹ㄋ一一丨
铝	钅口丨ㄋ一一
涤	氵夂一丨丿丶
喽	口米ㄋ丿一一
恃	忄土一丨丶丶
砌	石七ㄋ丿丿丿
楞	木罒丶一ㄋ丿
遁	十丨ㄋ一一
阱	阝井一一丿丨
咎	夂卜丨ㄋ一一
洼	氵圭一丨一一
炳	火丙丿丶丶丶
噬	口一丨一丿
枫	木几丿丶丶丶
拷	扌耂一ㄋㄋㄋ
哆	口夕丿ㄋ丶丶
矶	石几丿ㄋㄋㄋ
苇	艹韦一一ㄋ丨
翩	户ㄋ丶一ㄋ
窒	穴至一ㄋ丶一
侬	亻农丶ㄋ丿ㄋ
靶	革巴ㄋ丨一ㄋ
胰	月大ㄋ一ㄋㄋ
芜	艹一一丿ㄋㄋ
妾	立女ㄋ丿一一
嚎	口一丿ㄋ丿
辫	辛纟丶一丶丿
踉	丶ㄋ一一ㄋ
幌	巾日丨丶丿一
佃	亻田丨ㄋ一丨
葫	艹古丿ㄋ一一
拽	扌日ㄋ丿丿丿
皖	白宀一一丿ㄋ
滤	氵虍丶ㄋ丶丶
睬	目爫一丨丿丶
俞	亼⺝丨丨丨丨
匕	匕丿ㄋㄋㄋㄋ
嗤	口屮一丨ㄋ一
谤	讠丶一ㄋ丿
捍	扌日一一丨丨
孵	丶丿ㄋ丶丨
倪	亻臼丿ㄋㄋㄋ
瘾	疒阝丿ㄋㄋ一
敝	㡀攵丿一丿丶
匡	匚王一一丨一
绫	纟土丿丶丿ㄋ
磋	石一丨一一
尧	尧一ㄋ丿一一
淆	氵㐅一丿丨ㄋ
蕊	艹心丶ㄋ丶丶
烘	火共一丨丨一
璋	王音一丨丨丨
轧	车乚ㄋㄋㄋㄋ
亢	亠几丿ㄋㄋㄋ
赂	贝各丿ㄋ丶丨
榆	木亼丨ㄋ一一
蝗	虫白一一丨一
诛	讠丿丨丿丶丶
骏	马厶丿丶丿ㄋ
勺	勹丶丶丶丶丶
梵	林几丶丶丶丶
炽	火口丿丶丶丶
笠	立丶一丶丿
颌	合页一丿丨ㄋ
闸	门甲丨ㄋ一一
狒	犭弓ㄋ一ㄋㄋ
樊	木乂丿丶一丨
镕	钅穴丿丶丨ㄋ
缪	纟羽丿丶丿丿
瘟	疒日丨ㄋ丨丨
垢	土一丨ㄋ一
菇	艹女一丨丨ㄋ
琦	王大一丨ㄋ一
剃	弟刂丨丨丨丨
迸	䒑廾丶ㄋ丶丶
炫	火亠ㄋㄋ丶丶
溺	氵弓丶一丶一
惚	忄勿丶ㄋ丶丶
嗨	口氵丿一ㄋㄋ
陨	阝口丨ㄋ丿丶
赃	贝广一丨一一
羁	罒革ㄋㄋ一一
嘀	口丨ㄋ一丨
臻	至一丨丿丶
膳	月羊丶丿一丨
赣	音十丿ㄋ丶一
踌	一丨丶丶
殉	歹勹丨ㄋ一一
桔	木吉一丨一丨
瞿	目目丿丨丶一
闽	门虫丨ㄋ一丨
豚	月豕一丿ㄋ丿
沌	氵屯一ㄋ丨ㄋ
掺	扌丿丿丿丿
喳	口木丨ㄋ一一
惰	忄一丨一丨
椭	木阝一丿丨ㄋ
咪	口米丶丿一丨
霎	立ㄋ丿一一
侃	亻口丿丨ㄋㄋ
猝	犭亠丿丶丿丶
戮	羽人丿丿丿一
窖	穴告丿一丨一
祠	礻一丨ㄋ一
菁	艹青一一丨一
瞩	目尸丿丨ㄋ一
佬	亻耂丿ㄋㄋㄋ
躇	艹一丨一丿
肋	月力ㄋ丿丿丿
咄	口屮ㄋ丨丨丨
忡	忄中丨ㄋ一丨
雍	亠丿丿丨丶
蕾	艹丨ㄋ一丨
忱	忄冖丿ㄋㄋㄋ
跄	人ㄋㄋㄋㄋ
硅	石圭一丨一一
伎	亻十ㄋ丶丶丶
炊	火欠丿ㄋ丿丶
钊	钅刂丨丨丨丨
蝠	虫丨ㄋ一丨
拭	扌弋一丨一一
屎	尸米丶丿一丨
谛	讠丨ㄋ丨丨
褪	衤艮丶ㄋ丶丶
丞	了一一一一
卉	十廾一丿丨丨
隧	阝丷一丿ㄋ丿
茸	艹耳一丨丨一
钳	钅甘一丨丨一
啃	口止丨ㄋ一一
伢	亻牙一ㄋ丨丿
舔	舌天丨丶丶丶
闺	门圭一丨一一
蹬	癶一丨ㄋ一
眺	目儿丶一丿丶
挛	亦手丿一一丨
袱	衤亻一丿丶丶
陇	阝龙一丿ㄋ丿
殴	区殳丿ㄋㄋ丶
柿	木亠丨ㄋ丨丨
梧	木五丨ㄋ一一
惺	忄日丿一一丨
琛	王冖丿丶一丨
弛	弓也ㄋ丨ㄋㄋ
侥	亻尧一ㄋ丿一
捅	扌甬ㄋ丶丨ㄋ
酝	酉云一一ㄋ丶
薯	萝者一丨一丿
曳	日乚丿丿丿丿
澈	氵丨ㄋ一一
锈	钅禾ㄋ丿丿丿
稠	禾冂一丨一丨
眸	目厶丿一一丨
咆	口勹ㄋ一ㄋㄋ
簧	丨ㄋ一丨
鸥	区鸟丿ㄋ丶ㄋ
疡	疒㇡丿丿丿丿
渎	氵十ㄋ丶丶一
嬉	女壴丨ㄋ一一
汲	氵及丿ㄋ丶丶
脓	月农丶ㄋ丿ㄋ
穗	禾一丨ㄋ一一
骡	马田ㄋㄋ丶丨
拎	扌令丿丶丶ㄋ
巳	巳ㄋ一ㄋㄋㄋ
邢	开阝ㄋ丨丨丨
槛	木丨ㄋ丨丨
廿	廿一丨丨一一
搀	扌丿ㄋ丶丶
曙	日罒一丨一丿
樵	木隹丶丶丶丶
隅	阝日丨ㄋ丨一
筛	一丨ㄋ丨
谒	讠日丿ㄋ丿丶
倭	亻禾ㄋ丿一一
痹	疒畀丨ㄋ一丨
猖	犭日丨ㄋ一一
佯	亻羊丶丿一一
奚	爫幺一丿丶丶
肛	月工一丨一一
甭	不用丿ㄋ一一
抨	扌平一丶丿一
蛾	虫我丿一丨一
唠	口ㄋ丿丿丿
嵩	山丨ㄋ一一
荧	火丶丿丿丶
漱	氵束丿ㄋ丿丶
酋	酋丶丿一丨ㄋ
攘	扌亠丨ㄋ一丨
诘	讠吉一丨一丨
篡	目一丿丶ㄋ
睿	⺊冖一丿丶丿
噩	王口丨ㄋ一丨
怅	忄长丿一ㄋ丶
盎	冂大丨ㄋ丨丨
徙	彳止丨一丿丶
鞅	革冂一丿丶丶
漓	氵㐫丨ㄋㄋ丶
祟	屮凵一一丨丿
睫	目一ㄋ一一丨
攸	攵丿一丿丶
翎	令羽ㄋ丶一ㄋ
呛	口人ㄋㄋㄋㄋ
檀	木亠丨ㄋ丨ㄋ
筐	匚一一丨一
堑	车斤一丨一一
寅	宀一丨ㄋ一丨
磊	石石一丿丨ㄋ
驭	马又ㄋ丶丶丶
惘	忄冂丶丿一丶
吠	口犬一丿丶丶
驮	马大一丿丶丶
瑙	王巛丿丨ㄋ丿
炬	火匚ㄋ一一一
痉	疒轻ㄋ丶一丨
恺	忄山ㄋ一ㄋㄋ
曝	日日一丨丨一
萤	虫丨ㄋ一丨
胺	月宀ㄋ丿一一
敕	束攵丿一丿丶
筝	争丿ㄋㄋ一
幡	巾釆丨ㄋ一丨
霹	辟ㄋ一丿丨
竺	二一一一一
烙	火各丿ㄋ丶丨
毗	田比一ㄋ丿ㄋ
鸠	九鸟丿ㄋ丶ㄋ
蒜	艹示一一丨丿
埠	土丿丨ㄋ一ㄋ
阜	丿㠯一丨丨丨
嘈	口一丨ㄋ一丨
帷	巾隹丿丨丶一
乒	丘丿丿丿丿丿
啄	口豕丶丶丶丶
鳌	敖鱼丿ㄋ丨ㄋ
阙	门屰丿ㄋ丿丶
毡	毛占丨一丨ㄋ
褥	衤辰一丨丶丶
搔	扌又丶丨ㄋ一
笋	尹ㄋ一一丿
狞	犭宀一丨丨丨
韶	音刀丨ㄋ一一
冕	日丿ㄋㄋㄋ
骼	骨各丿ㄋ丶丨
蔼	艹讠丨ㄋ一一
烹	了丶丶丶丶
奄	大日ㄋㄋㄋㄋ
嫖	女覀一一丨丿
沐	氵木一丨丿丶
噗	口业丶丿一一
蛟	虫六丿丶丶丶
岑	山今丿丶丶ㄋ
弩	奴弓ㄋ一ㄋㄋ
咏	口丶ㄋㄋ丿丶
掳	扌虍ㄋ丿丿丿
捻	扌今丶ㄋ丶丶
圃	囗甫一丨ㄋ一
孚	爫子ㄋ丨一一
悴	忄亠丿丶丿丶
呱	口瓜丿丿ㄋ丶
诣	讠匕丨ㄋ一一
祁	礻阝ㄋ丨丨丨
捶	扌垂丿一丨一
钠	钅内丨ㄋ丿丶
袄	衤夭丿一丿丶
澎	氵壴丿丿丿丿
氮	气火丶丿丿丶
恪	忄各丿ㄋ丶丨
雏	刍隹丿丨丶一
彷	彳方丶一ㄋ丿
撮	扌日一丨丨一
鹦	贝贝ㄋ丿一丿
堰	土匚丨ㄋ一一
晖	日冖一ㄋ一丨
犀	尸氺丿一一丨
腑	月广丿丶一丨
沽	氵古一丨丨ㄋ
橄	木乛一丨丨一
掐	扌丿丨一ㄋ
亵	亠执丿ㄋ丿丶
龋	齿丿丨ㄋ一丨
嗒	口艹丿丶一丨
咀	口且丨ㄋ一一
祺	礻其一丨丨一
锚	钅艹丨ㄋ一丨
匾	匚户丨ㄋ一丨
萃	艹亠丿丶丿丶
乓	丘丶丶丶丶丶
贻	贝厶丨ㄋ一一
觑	虍业丨ㄋ丿ㄋ
揖	扌口一丨丨一
憔	忄隹丶丶丶丶
吝	文口丨ㄋ一一
羌	乚ㄋㄋㄋㄋ
蠕	虫一丿丨ㄋ
砾	石丨丿丶丶
诲	讠ㄋㄋ丶一
肴	乂丨ㄋ一一
撩	扌大丶丿丨ㄋ
坍	土冂丶一一一
酥	酉禾丿一丨丿
袅	衣丶一丿ㄋ
黝	黑幺ㄋ丿丿丿
俾	亻卑丿丨ㄋ一
嫣	女正ㄋ一丶丶
穹	穴弓ㄋ一ㄋㄋ
秧	禾冂一丿丶丶
妊	女壬丿一丨一
溉	氵一ㄋ丿ㄋ
鹊	龷日丿ㄋ丶ㄋ
聿	聿ㄋ一一一一
疙	疒ㄋㄋㄋㄋ
蘑	艹麻一丿丨ㄋ
睾	丿罒一丨一一
楷	木比丿丨ㄋ一
茹	艹女丨ㄋ一一
酵	酉耂ㄋ丨一一
锌	钅辛丶一丶丿
滇	氵直丿丶丶丶
辗	车尸一丨丨一
纂	目一丿丶ㄋ
圭	圭一丨一一丨
幔	巾日丨ㄋ丨丨
褒	亠亻丨ㄋ一一
揍	扌丿一丿丶
倔	亻尸ㄋ丨丨ㄋ
诽	讠非丨一一一
颉	吉页一丿丨ㄋ
腓	月非丨一一一
锄	钅且ㄋ丿丿丿
嗔	口直丿丶丶丶
磺	石丨ㄋ一丨
攒	扌先丿一丨一
雳	厂ㄋ丿丿丿
瘩	疒艹丿丶一丨
悚	忄束一丨ㄋ一
吆	口幺ㄋㄋ丶丶
墩	土ㄋ丨一丿
彝	彑米ㄋㄋ丶丨
逍	⺝丶ㄋ丶丶
囱	夂一一一一
辄	车耳ㄋㄋㄋㄋ
俨	亻亚丿丿丿丿
桅	木厃ㄋㄋㄋㄋ
纶	纟仑丿丶丿ㄋ
悸	忄禾ㄋ丨一一
殃	歹冂一丿丶丶
帧	巾⺊丨ㄋ丿丶
俐	亻禾丨丨丨丨
绮	纟大一丨ㄋ一
袒	衤旦丨ㄋ一一
籽	米子ㄋ丨一一
孰	孑丿ㄋ丶丶
愫	忄ㄋㄋ丶丨
拌	扌半丶丿一一
橙	木癶一丨ㄋ一
暨	旡丨ㄋ一一
敖	敖一一丨一ㄋ
赘	敖贝丨ㄋ丿丶
抉	扌丿丶丶丶
剌	束刂丨丨丨丨
娼	女日丨ㄋ一一
淤	氵方丿丶丶丶
顼	王页一丿丨ㄋ
哝	口农丶ㄋ丿ㄋ
葵	艹癶一一丿丶
酣	酉甘一丨丨一
麓	林鹿丶一丿ㄋ
琅	王丶ㄋ一一ㄋ
钵	钅木一一一一
簸	其ㄋ丿丨ㄋ
禾	禾丿一丨丿丶
铢	钅丿丨丿丶丶
璧	辟王丶丶丶丶
娠	女辰一丿一一
彗	丰丰ㄋ一一一
惋	忄宀丿ㄋ丶ㄋ
腋	月亠丿丶丿ㄋ
螂	虫丶ㄋ一一ㄋ
阪	阝ㄋ丶丶丶
掣	巾丨丨丿一
劾	亥力ㄋ丿丿丿
沥	氵厂ㄋ丿丿丿
嚓	口宀丿ㄋ丶丶
粱	氵刀丿丶丶丿
惮	忄单丶丿丨ㄋ
氖	气乃ㄋ丿丿丿
捎	扌丨ㄋ一一
羔	灬丶丶丶丶
俟	亻厶丿一一丿
渲	氵宀一丨ㄋ一
榄	木丨ㄋ丿ㄋ
茧	艹虫丨ㄋ一丨
霓	臼丿ㄋㄋㄋ
胥	疋⺝丨ㄋ一一
鹉	一弋丨一丨一
橘	木矛丨ㄋ丿丶
琶	王王ㄋ丨一ㄋ
撬	扌毛丿一一ㄋ
拈	扌占丨一丨ㄋ
笆	巴ㄋ丨一ㄋ
痊	疒人一一丨一
亟	了口ㄋ丶一一
渭	氵田丨ㄋ一一
狙	犭且丨ㄋ一一
珂	王可一丨ㄋ一
刨	勹巳丨丨丨丨
蜕	虫𠮦丿ㄋㄋㄋ
谚	讠一丿丿丿
瞟	目覀一一丨丿
憧	忄立丨ㄋ一一
拗	扌幺ㄋ丿丿丿
馒	饣日丨ㄋ丨丨
钗	钅又丶丶丶丶
帚	彐冖丨ㄋ丨丨
哧	口赤丿丨丿丶
喋	口廿ㄋ一丨丿
箫	肀丿丨丿丶
刁	一一一一一
怦	忄平一丶丿一
缭	纟大丶丿丨ㄋ
迥	冂口丶ㄋ丶丶
湄	氵丨ㄋ一一
渝	氵亼丨ㄋ一一
磐	舟殳一丿丨ㄋ
冗	冖几丿ㄋㄋㄋ
闵	门文丶一丿丶
黏	禾人丨丶一丿
噶	口艹丨ㄋ一一
蕃	艹釆丨ㄋ一丨
驿	马又一一丨丨
弼	弓一丿丨ㄋ一
淄	氵巛丨ㄋ一丨
饺	饣六丿丶丶丶
韬	韦爫丿丨一ㄋ
踞	尸一丨丨ㄋ
婷	女一丨丨丨
蜒	虫丿丨一丨一
唆	口厶丿丶丿ㄋ
偎	亻田一ㄋ丿丶
漉	氵鹿丶一丿ㄋ
榨	木穴丿一丨一
矜	矛今丿丶丶ㄋ
皈	白ㄋ丶丶丶
碉	石冂一丨一丨
笈	及丿ㄋ丶丶
鲨	氵少丿ㄋ丨ㄋ
枷	木加ㄋ丿丨ㄋ
蹑	耳ㄋ丶ㄋ丶
瀚	氵丿丶ㄋ丶
癖	疒辟ㄋ一丿丨
谑	讠虍一ㄋ一一
酪	酉各丿ㄋ丶丨
炙	火丶丿丿丶
揩	扌比丿丨ㄋ一
蜷	虫ㄋㄋㄋㄋ
烬	火尺丶丶丶丶
侏	亻丿丨丿丶丶
凋	冫冂一丨一丨
漪	氵犭一丿丶一
悻	忄土丶丿一一
讪	讠山丨ㄋ丨丨
蹋	日ㄋ丶一ㄋ
搐	扌亠ㄋㄋ丶丨
碘	石曲丿丶丶丶
帛	白巾丨ㄋ丨丨
诠	讠人一一丨一
碾	石尸一丨丨一
擂	扌丨ㄋ一丨
苯	艹木一一一一
诃	讠可一丨ㄋ一
铎	钅又一一丨丨
荀	芍日丨ㄋ一一
戊	戊一丿ㄋ丿丶
驹	马勹丨ㄋ一一
攫	扌目丨ㄋ一一
憬	忄日丶一丨ㄋ
哽	口更一丨ㄋ一
踵	千丨ㄋ一一
蟒	虫艹一丿丶丶
漾	氵丶ㄋㄋ丿
啧	口丨ㄋ丿丶
楠	木十丨ㄋ丶丿
吮	口厶丿ㄋㄋㄋ
氟	气弓丿丨丨丨
怂	从心丶ㄋ丶丶
叼	口一一一一
漩	氵族ㄋ丨一丿
偕	亻比丿丨ㄋ一
竣	立厶丿丶丿ㄋ
蹭	曾丶丿丨ㄋ
翌	羽立丶一丶丿
臆	月音丶ㄋ丶丶
挝	扌寸丶ㄋ丶丶
崽	山田丶ㄋ丶丶
绚	纟勹丨ㄋ一一
糜	麻米丶丿一丨
瘢	疒舟丿ㄋㄋ丶
跤	六丿丶丶丶
阑	门束丶丶丶丶
恬	忄舌丿一丨丨
豢	豕一丿ㄋ丿
跷	尧一ㄋ丿一
汶	氵文丶一丿丶
琵	王王一ㄋ丿ㄋ
憨	乛耳丿一丿丶
蜗	虫口丨ㄋ丿丶
螅	虫自丶ㄋ丶丶
惴	忄山一丿丨ㄋ
戟	戈一ㄋ丿丶
匮	匚丨ㄋ丿丶
恙	心丶ㄋ丶丶
桢	木⺊丨ㄋ丿丶
抿	扌民ㄋ一ㄋ一
笺	戋一一ㄋ丿
瞳	目立丨ㄋ一一
蛤	虫合丿丶一丨
瓢	覀示丿丿ㄋ丶
跺	几一丨丿丶
芹	艹斤丿丿一丨
秤	禾平一丶丿一
潦	氵大丶丿丨ㄋ
哒	口大丶ㄋ丶丶
饬	饣ㄋ丿丿丿
栩	木羽ㄋ丶一ㄋ
曦	日一丨丿丶
骷	骨古一丨丨ㄋ
鬓	髟宀丿丨一丨
卤	占乂丿丶丶丶
嫡	女丨ㄋ一丨
丕	不一一一一一
梓	木辛丶一丶丿
嗖	口臼丨ㄋ丶丶
惦	忄广丨一丨ㄋ
浚	氵厶丿丶丿ㄋ
咔	口上丨丶丶丶
荃	艹人一一丨一
藐	艹豸丿丨ㄋ一
唧	口ㄋ丨丨丨
玺	尔王丶丶丶丶
铐	钅耂一ㄋㄋㄋ
汛	氵乙一丨丨丨
髅	骨米ㄋ丿一一
渤	氵ㄋ丨一ㄋ
皿	皿丨ㄋ丨丨一
箍	扌一ㄋ丨ㄋ
馅	饣丿丨一ㄋ
汾	氵分丿丶ㄋ丿
戍	戊丶丶丶丶丶
痔	疒土一丨丶丶
褶	衤羽丿丨ㄋ一
聆	耳令丿丶丶ㄋ
涎	氵丿丨一丨一
汞	工水丨ㄋ丿丶
巅	山直丿丶一丿
渍	氵丨ㄋ丿丶
疣	疒尢丶丶丶丶
奂	冂一丿丶丶
傩	亻又丿丨丶一
逵	土八一丨一丶
耆	耂匕丨ㄋ一一
鳄	鱼吅一一ㄋㄋ
蟋	虫釆丶ㄋ丶丶
讹	讠化丿丨丿ㄋ
膺	广亻丿丨丶一
蹿	穴丨ㄋ一丨
沂	氵斤丿丿一丨
筏	亻一ㄋ丿丶
釜	父干丶丿一一
坯	土不一一一一
峦	亦山丨ㄋ丨丨
茬	艹一丨一一
摒	扌尸丶丿一一
蟀	虫亠ㄋㄋ丶丶
撵	扌夫一一丿丶
缤	纟宀丿丨一丨
浒	氵讠丿一一丨
珑	王龙一丿ㄋ丿
嵋	山丨ㄋ一一
苞	芍巳ㄋ一ㄋㄋ
瑾	王堇一丨丨一
泵	石水丨ㄋ丿丶
暧	日一丿ㄋ丶
钾	钅甲丨ㄋ一一
赓	广彐丿丶丨ㄋ
叟	臼丨ㄋ丶丶丶
佚	亻丿一一丿丶
沓	水日丨ㄋ一一
撂	扌田丿ㄋ丶丨
蛊	虫皿丨ㄋ丨丨
晏	日宀ㄋ丿一一
璐	王丿ㄋ丶丨
甥	生田ㄋ丿丿丿
瘪	疒自丿丶丿ㄋ
漳	氵音一丨丨丨
阉	门大丨ㄋ一一
蹂	矛一丨丿丶
琏	王车丶ㄋ丶丶
鳃	鱼田丶ㄋ丶丶
湃	氵一一一一
辘	车鹿丶一丿ㄋ
鼾	自畀一一丨丨
躏	艹丶丨ㄋ丿
僭	亻旡一ㄋ丿ㄋ
懵	忄萝丶ㄋ丨ㄋ
褚	衤者一丨一丿
镰	钅广丶丿一ㄋ
寐	宀爿丨丿丶丶
攥	扌丨ㄋ一一
涧	氵门丨ㄋ一一
蝙	虫户丨ㄋ一丨
脐	月文丿丨丨丨
辕	车土丨ㄋ一丿
涣	氵丨ㄋ一丿
煜	火日丶一丶丿
骥	马北丨ㄋ一丨
杞	木己ㄋ一ㄋㄋ
嗳	口一丿ㄋ丶
祯	礻⺊丨ㄋ丿丶
傣	亻丨丶一丿
酉	酉一丨ㄋ丿ㄋ
鑫	金金丿丶一一
瑕	王叚ㄋ一丨一
捺	扌大一一丨丿
秸	禾吉一丨一丨
馋	饣丿ㄋ丶丶
窿	穴阝丿ㄋ丶一
楔	木丰ㄋ丿一丿
胱	月光丨丶丿一
荔	艹力ㄋ丿ㄋ丿
蟆	虫莫一丨丨丨
遐	叚辶丶ㄋ丶丶
屹	山ㄋㄋㄋㄋ
湍	氵山一丿丨ㄋ
轲	车可一丨ㄋ一
镯	钅罒丿ㄋ丨ㄋ
缰	纟一丨ㄋ一丨
桦	木化一丨丨丨
炖	火屯一ㄋ丨ㄋ
啬	十䒑丨ㄋ丨ㄋ
诩	讠羽ㄋ丶一ㄋ
羚	羊令丿丶丶ㄋ
钡	气贝丨ㄋ丿丶
绯	纟非丨一一一
掖	扌亠丿丶丿ㄋ
箓	丨ㄋ丿丶
涸	氵囗一丨丨ㄋ
鸳	夕丿ㄋ丶ㄋ
塾	孑丿ㄋ丶一
呸	口不一一一一
抡	扌仑丿丶丿ㄋ
熹	壴口丶丶丶丶
擞	扌米ㄋ丿一丿
坷	土可一丨ㄋ一
筵	丿丨一丨一
嗟	口一丨一一
瓮	公瓦一ㄋㄋ丶
跛	皮ㄋ丿丨ㄋ
亘	一旦丨ㄋ一一
汕	氵山丨ㄋ丨丨
欤	与一丿ㄋ丿丶
壑	⺊冖一丿丶丿
颍	匕水一丿丨ㄋ
姗	女冂丨ㄋ一一
溥	氵甫一丨丶丶
踊	甬ㄋ丶丨ㄋ
枭	木一丨丿丶
暄	日宀一丨ㄋ一
稷	禾田丿丶丿ㄋ
跚	冂丨ㄋ一一
笙	生丿一一丨
涟	氵车丶ㄋ丶丶
瀛	氵赢ㄋ丿一一
滕	月丨丶一丿
踝	日一丨丿丶
贰	弋二丨ㄋ丿丶
瞰	目乛一丨丨一
恻	忄贝丨丨丨丨
嚏	口丨ㄋ一丨
迢	刀口丶ㄋ丶丶
獗	犭厂丶丿一ㄋ
睑	目亼丶丶丿一
邯	甘阝ㄋ丨丨丨
萦	糸ㄋㄋ丶丨
赡	贝厃丿丶丶一
珥	王耳一丨丨一
酮	酉冂一丨ㄋ一
璞	王业丶丿一一
羹	灬丶丿一一
缄	纟戊一丨ㄋ一
鸾	亦鸟丿ㄋ丶ㄋ
俸	亻一一丨丨
晾	日京丶一丨ㄋ
媲	女丿丶一一
蜿	虫宀丿ㄋ丶ㄋ
恿	甬心丶ㄋ丶丶
讷	讠内丨ㄋ丿丶
扈	户口ㄋ丨一ㄋ
蜈	虫口一一丿丶
犊	牜十ㄋ丶丶一
蓓	荷立丨ㄋ一一
翟	羽隹丿丨丶一
藕	艹耒丨ㄋ一一
戌	戊一一一一一
鋆	土勹丶一丿丶
谩	讠日丨ㄋ丨丨
谀	讠臼丿丶丶丶
岐	山十ㄋ丶丶丶
卯	卯丿ㄋ丿ㄋ丨
谙	讠音丶一丶丿
蝎	虫日丿ㄋ丿丶
荼	艹亼一丨丿丶
甄	覀土一ㄋㄋ丶
镀	钅度ㄋ丶丶丶
蟾	虫厃丿丶丶一
椰	木耳ㄋ丨丨丨
蹊	爫ㄋㄋ丶一
泞	氵宀一丨丨丨
螃	虫丶一ㄋ丿
撸	扌鱼丨ㄋ一一
檬	木一一丿ㄋ
猓	犭日一丨丿丶
蔷	艹十丶丿一丨
羲	禾一ㄋ一ㄋ
瘸	疒加丨ㄋ丿丶
蘸	艹酉丿丨丶一
蔗	艹度丶丶丶丶
傀	亻鬼丿丨ㄋ一
锢	钅囗一丨丨ㄋ
蚌	虫丰一一一丨
邃	穴丷一丿ㄋ丿
遽	虍豕丶ㄋ丶丶
恚	圭心丶ㄋ丶丶
簌	束丿ㄋ丿丶
锵	钅丬丿ㄋ丶一
皑	白山ㄋ一ㄋㄋ
昊	日天一一丿丶
焙	火立丨ㄋ一一
鹳	艹吅丿丨丶一
睽	目癶一一丿丶
刽	人云丨丨丨丨
寰	宀罒一丨ㄋ一
噎	口一丨ㄋ一
呗	口贝丨ㄋ丿丶
鳖	㡀攵丿ㄋ丨ㄋ
殡	歹宀丿丨一丨
唷	口丨ㄋ一一
恣	次心丶ㄋ丶丶
睐	目夹丨丿丶丶
诰	讠告丿一丨一
淖	氵⺊丨ㄋ一一
婵	女单丶丿丨ㄋ
榈	木门丨ㄋ一丨
氦	气亥丶一ㄋ丿
靳	革斤丿丿一丨
蛹	虫甬ㄋ丶丨ㄋ
蹙	戊上丨丿丶丨
鸯	冂大丿ㄋ丶ㄋ
惬	忄匚一丶丿一
罡	罒正一丨一丨
眈	目冖丿ㄋㄋㄋ
诙	讠丶丿丿丶
胤	丿幺丨ㄋ一一
缮	纟羊丶丿一丨
皋	白大一丨丨丨
蛀	虫主丶一一丨
偌	亻艹一丿丨ㄋ
绛	纟夂一ㄋ丨丨
疵	疒此丨一丨一
葆	荷呆丨ㄋ一一
黔	黑今丿丶丶ㄋ
喙	口彑丿ㄋ丿丿
儡	亻田丨ㄋ一丨
烽	火夂一一一丨
佼	亻六丿丶丶丶
斓	文门一丨ㄋ一
颚	吅二ㄋ一丿丨
嫔	女宀丿丨一丨
龈	齿艮ㄋ一一ㄋ
盅	中皿丨ㄋ丨丨
娓	女尸丿一一ㄋ
坂	土ㄋ丶丶丶
町	田丁一丨丨丨
芥	艹人丿丨丨丨
瘠	疒丿丶丨ㄋ
啜	口双ㄋ丶ㄋ丶
橇	木毛丿一一ㄋ
荟	艹人一一ㄋ丶
挎	扌大一一ㄋㄋ
阂	门亥丶一ㄋ丿
淇	氵其一丨丨一
垛	土几一丨丿丶
瓒	王先丿一丨一
篓	米ㄋ丿一一
虱	丿丨ㄋ一丨
跻	文丿丨丨丨
髯	髟冂一丨一一
龛	合龙一丿ㄋ丿
蹒	艹一丨ㄋ丿
瞠	目一丨一一
痫	疒门一丨丿丶
掂	扌广丨一丨ㄋ
酰	酉先丿一丨一
潼	氵立丨ㄋ一一
镁	钅一丿丶丶
筱	丿一丿丶
腆	月曲丿丶丶丶
灸	久火丶丿丿丶
谆	讠ㄋ丨一一
茗	艹夕丨ㄋ一一
骋	马由一ㄋㄋㄋ
壬	壬丿一丨一一
椋	木京丶一丨ㄋ
蛔	虫回丨ㄋ丨ㄋ
潺	氵尸ㄋ丨一一
扉	户非丨一一一
耘	耒云一一ㄋ丶
槟	木宀丿丨一丨
甬	甬ㄋ丶丨ㄋ一
雹	勹ㄋ一ㄋㄋ
淞	氵木丿丶ㄋ丶
谥	讠䒑丿丶丨ㄋ
蕙	艹一丨ㄋ一一
燎	火大丶丿丨ㄋ
蚪	虫⺀一丨丨丨
蜻	虫青一一丨一
轶	车丿一一丿丶
郸	单阝ㄋ丨丨丨
楣	木丨ㄋ一一
狰	犭争丿ㄋㄋ一
荪	艹孑丨丿丶丶
捋	扌爫一丨丶丶
涓	氵口丨ㄋ一一
娄	米女ㄋ丿一一
麝	鹿身一丨丶丶
薰	艹千丨ㄋ丶丿
蚤	又丶丨ㄋ一丨
醮	酉隹丶丶丶丶
搪	扌广ㄋ一一丨
瞌	目去丨ㄋ丨丨
谧	讠心丿丨ㄋ丨
湮	氵覀一丨一一
辍	车双ㄋ丶ㄋ丶
茉	艹未丨丿丶丶
樟	木音一丨丨丨
梆	木ㄋ丨丨丨
岖	山区一丿丶ㄋ
臼	臼丿丨一ㄋ一
癣	疒鱼丶丿一一
穑	禾十丶丿一丨
玷	王占丨一丨ㄋ
馍	饣莫一丨丨丨
呷	口甲丨ㄋ一一
妩	女一一丿ㄋㄋ
萼	艹吅一一ㄋㄋ
伫	亻宀一一一一
彤	冂亠丿丿丿丿
媛	女爫一一丿ㄋ
莓	艹ㄋㄋ丶一
岬	山甲丨ㄋ一一
惆	忄冂一丨一丨
鳎	鱼日ㄋ丶一ㄋ
囔	口丨ㄋ一丨
啾	口禾丶丿丿丶
蜓	虫壬ㄋ丶丶丶
孺	孑一丿丨ㄋ
徇	彳勹丨ㄋ一一
徵	壬丿一丨一
焊	火日一一丨丨
昵	日尸丿ㄋㄋㄋ
岱	代山丨ㄋ丨丨
飙	犬犬一丿丶丶
卅	一川丿丨丨丨
邙	亡阝ㄋ丨丨丨
痞	疒不丨ㄋ一一
隼	隹十一丨丨丨
恫	忄冂一丨ㄋ一
桀	夕㐄一丨丿丶
怆	忄人ㄋㄋㄋㄋ
绶	纟ㄋ丶丶丶
裆	衤ㄋ一一一
盂	于皿丨ㄋ丨丨
桧	木人一一ㄋ丶
蚓	虫弓丨丨丨丨
嗷	口敖一一丨一
槌	木丿丨ㄋ一ㄋ
抠	扌区一丿丶ㄋ
芮	艹内丨ㄋ丿丶
蚣	虫公丿丶ㄋ丶
痘	疒豆一丨ㄋ一
痢	疒禾丨丨丨丨
铿	钅一丨一一
闩	门一一一一一
飓	几乂一ㄋ一一
蝌	虫禾丶丶一丨
疱	疒勹ㄋ一ㄋㄋ
撅	扌厂丶丿一ㄋ
蚯	虫丘丿丨一丨
窠	穴日一丨丿丶
斡	人丶丶一丨
荚	艹夹丿丶丶丶
耷	大耳一丨丨一
砚	石见丨ㄋ丿ㄋ
牒	片廿ㄋ一丨丿
煦	日勹丨ㄋ一丶
赈	贝辰一丿一一
嗫	口耳ㄋ丶ㄋ丶
耙	耒巴ㄋ丨一ㄋ
榕	木穴丿丶丨ㄋ
鞑	革大丶ㄋ丶丶
醺	酉千丨ㄋ丶丿
袤	亠矛丿ㄋ丿丶
谌	讠其ㄋㄋㄋㄋ
秆	禾干一一丨丨
翡	非羽ㄋ丶一ㄋ
徨	彳白一一丨一
橹	木鱼丨ㄋ一一
缨	纟贝丨ㄋ丿丶
锹	钅禾丶丿丿丶
嵇	禾尢丶丨ㄋ丨
圪	土ㄋㄋㄋㄋ
髻	髟吉一丨一丨
嗬	口艹丿丶一丨
痣	疒士丶ㄋ丶丶
辎	车巛丨ㄋ一丨
谄	讠丿丨一ㄋ
娩	女丿ㄋㄋㄋ
蛐	虫曲丨ㄋ一丨
鹞	爫缶丿ㄋ丶ㄋ
翱	白大一丨ㄋ丶
庖	广勹ㄋ一ㄋㄋ
籁	束丿ㄋ丨ㄋ
鳗	鱼日丨ㄋ丨丨
蓿	艹宀丿丶一丿
疟	疒一ㄋ一一
鲇	鱼占丨一丨ㄋ
颔	今口一丿丨ㄋ
黠	黑吉一丨一丨
嚅	口一丿丨ㄋ
瘀	疒方丿丶丶丶
黜	黑屮ㄋ丨丨丨
濑	氵束丿ㄋ丨ㄋ
忐	上心丶ㄋ丶丶
馁	饣爫ㄋ丿一一
洵	氵勹丨ㄋ一一
忑	下心丶ㄋ丶丶
砥	石氏丶丶丶丶
咂	口匚丨ㄋ丨丨
罹	罒忄丿丨丶一
糠	米广ㄋ一一丨
偃	亻匚丨ㄋ一一
匝	匚巾丨ㄋ丨丨
淙	氵宀一一丨丿
喏	口艹一丿丨ㄋ
纫	纟刀丶丶丶丶
闾	门口丨ㄋ一一
祛	礻去一丨一ㄋ
腼	月面一丿丨ㄋ
蛰	执虫丨ㄋ一丨
曜	日羽丿丨丶一
涝	氵ㄋ丿丿丿
厩	厂一ㄋ丿ㄋ
闰	门王一一丨一
疽	疒且丨ㄋ一一
煊	火宀一丨ㄋ一
洄	氵回丨ㄋ丨ㄋ
璜	王丨ㄋ一丨
藓	艹鱼丶丿一一
汐	氵夕丿ㄋ丶丶
铬	钅各丿ㄋ丶丨
渥	氵尸一ㄋ丶一
靼	革旦丨ㄋ一一
噤	口林一一丨丿
苓	艹令丿丶丶ㄋ
酗	酉乂ㄋ丨丨丨
咫	尺口丿丶丶丶
椿	木丨ㄋ一一
鲫	鱼ㄋ丨丨丨
锭	钅定丶丶ㄋ一
锺	钅千丨ㄋ一一
罔	冂䒑丶一ㄋㄋ
匍	勹甫一丨ㄋ一
祗	礻氏丶丶丶丶
锰	钅子丨ㄋ丨丨
岌	山及丿ㄋ丶丶
馀	饣亼一丨丿丶
畹	田宀丿ㄋ丶ㄋ
熠	火羽丿丨ㄋ一
胫	月轻ㄋ丶一丨
銮	亦金丿丶一一
糯	米一丿丨ㄋ
沅	氵元一一丿ㄋ
棣	木丨丶一丿
旌	族生丿一一丨
孢	孑勹ㄋ一ㄋㄋ
豌	豆宀丿ㄋ丶ㄋ
盹	目屯一ㄋ丨ㄋ
驸	马亻一丨丶丶
腌	月大丨ㄋ一一
熵	火丨ㄋ丿丶
镭	钅丨ㄋ一丨
镐	钅丨ㄋ一一
馐	饣ㄋ丨一一
癞	疒束丿ㄋ丨ㄋ
骰	骨殳丿ㄋㄋ丶
嘤	口贝丨ㄋ丿丶
阖	门去丨ㄋ丨丨
瞑	目冖丨ㄋ一一
韭	非一一一一一
裨	衤卑丿丨ㄋ一
戾	户犬一丿丶丶
宕	宀石一丿丨ㄋ
镌	钅隹ㄋ丿丿丿
溟	氵冖丨ㄋ一一
隽	隹乃ㄋ丿丿丿
牍	片十ㄋ丶丶一
婊	女丿ㄋ丿丶
鹄	告鸟丿ㄋ丶ㄋ
拄	扌主丶一一丨
埂	土更一丨ㄋ一
虬	虫乚ㄋㄋㄋㄋ
娲	女口丨ㄋ丿丶
萱	艹宀一丨ㄋ一
蠡	彑丨ㄋ一丨
啵	口氵ㄋ丿丨ㄋ
芋	艹于一一丨丨
胭	月因丨ㄋ一丿
豺	豸才一丨丿丿
褛	衤米ㄋ丿一一
啻	巾丨ㄋ一一
蛆	虫且丨ㄋ一一
柠	木宀一丨丨丨
掰	分丿一一丨
篆	彑丿ㄋ丿丿
咛	口宀一丨丨丨
倌	亻宀丨ㄋ一ㄋ
蛭	虫至一ㄋ丶一
莞	艹宀一一丿ㄋ
澹	氵厃丿丶丶一
纭	纟云一一ㄋ丶
谡	讠田丿丶丿ㄋ
荨	艹彐一丨丶丶
潞	氵丿ㄋ丶丨
郅	至阝ㄋ丨丨丨
飕	几乂丿丨一ㄋ
螳	虫一丨一一
弋	弋一ㄋ丶丶丶
胄	由⺝丨ㄋ一一
蟑	虫音一丨丨丨
猥	犭田一ㄋ丿丶
蟠	虫釆丨ㄋ一丨
昙	日云一一ㄋ丶
宓	宀心丿丿丿丿
锏	钅门丨ㄋ一一
烯	火乂一丿丨ㄋ
濮	氵亻丨丨丶丿
柑	木甘一丨丨一
匐	勹丨ㄋ一丨
蟮	虫羊丶丿一丨
仄	厂人丿丶丶丶
粼	米夕一ㄋ丨ㄋ
蜃	辰虫丨ㄋ一丨
箴	戊一丨ㄋ一
偈	亻日丿ㄋ丿丶
祐	礻丨ㄋ一一
嗥	口白一丿丶一
褴	衤丨ㄋ丨丨
蕨	艹厂丶丿一ㄋ
圩	土于一一丨丨
蓟	艹鱼丨丨丨丨
杳	木日丨ㄋ一一
魇	厂犬丿丨ㄋ一
孪	亦子ㄋ丨一一
簪	旡一ㄋ丿ㄋ
荤	车一ㄋ一丨
诿	讠禾ㄋ丿一一
氲	气日丨ㄋ丨丨
飒	立几丿丶丶丶
镂	钅米ㄋ丿一一
摞	扌田ㄋㄋ丶丨
夙	几歹一丿ㄋ丶
舀	爫臼丿丨一ㄋ
臧	戊爿一丨ㄋ一
貂	豸刀丨ㄋ一一
蒿	艹丨ㄋ一一
蜥	虫木丿丿一丨
蹩	㡀攵丨ㄋ一丨
噼	口辟ㄋ一丿丨
钛	钅大丶丶丶丶
钚	钅不一丿丨丶
铠	钅山ㄋ一ㄋㄋ
霭	讠丨ㄋ一一
皙	木斤丿丨ㄋ一
濂	氵广丶丿一ㄋ
鲈	鱼⺊ㄋ一丿丿
獾	犭艹丨ㄋ一丨
霾	豸丨ㄋ一一
叵	匚口丨ㄋ一一
泯	氵民ㄋ一ㄋ一
碴	石木丨ㄋ一一
鸵	鸟宀丿ㄋㄋㄋ
峪	山八丿丶丨ㄋ
饕	口丂丨一ㄋ丿
瘁	疒亠丿丶丿丶
睢	目隹丿丨丶一
鬃	髟宀一一丨丿
纣	纟寸一丨丶丶
迩	尔辶丶ㄋ丶丶
夔	䒑自丨一丨一
榭	木身一丨丶丶
垠	土艮ㄋ一一ㄋ
饨	饣屯一ㄋ丨ㄋ
篝	丨ㄋ一丨
娑	氵少ㄋ丿一一
隍	阝白一一丨一
榔	木丶ㄋ一一ㄋ
浜	氵丘丿丶丶丶
鲑	鱼圭一丨一一
洌	氵歹丨丨丨丨
浣	氵宀一一丿ㄋ
汩	氵囗一一一一
舐	舌氏丿ㄋ一ㄋ
谔	讠吅一一ㄋㄋ
忻	忄斤丿丿一丨
瞭	目大丶丿丨ㄋ
咻	口亻一丨丿丶
鹑	孑丿ㄋ丶ㄋ
唑	口从一丨一一
皎	白六丿丶丶丶
懋	木矛一丨丿丶
诒	讠厶丨ㄋ一一
麾	麻毛丿一一ㄋ
辏	车丿一丿丶
冽	冫歹丨丨丨丨
氐	氏丶丶丶丶丶
箕	其丿丶丶丶
俚	亻里丨ㄋ一一
宸	宀辰一丿一一
汴	氵丶一丨丶丶
捱	扌厂一丨一一
芍	芍丶丶丶丶丶
摺	扌羽丿丨ㄋ一
摈	扌宀丿丨一丨
簦	癶一丨ㄋ一
咝	口ㄋㄋ一一
箔	氵丿丨ㄋ一
孀	女一丨丿丶
怏	忄冂一丿丶丶
谝	讠户丨ㄋ一丨
漕	氵一丨ㄋ一丨
砧	石占丨一丨ㄋ
罂	贝贝丿一一丨
耄	耂匕丿一一ㄋ
馕	饣丨ㄋ一丨
烷	火宀一一丿ㄋ
栾	亦木一丨丿丶
沣	氵丰一一一丨
榘	大一ㄋ一丨
鹫	京尢丶丿ㄋ丶
缜	纟直丿丶丶丶
沱	氵宀丿ㄋㄋㄋ
俑	亻甬ㄋ丶丨ㄋ
榷	木冖丿丨丶一
蛳	虫一丨ㄋ丨
泗	氵口丿ㄋㄋㄋ
衢	彳目丨ㄋ一一
剽	覀示丨丨丨丨
臊	月口丨ㄋ一丨
瘴	疒音一丨丨丨
晁	日儿丶一丿丶
纾	纟予ㄋ丶ㄋ丨
酚	酉分丿丶ㄋ丿
炀	火㇡丿丿丿丿
孛	子ㄋ丨一一
叁	三一一一一
憩	舌自丶ㄋ丶丶
掬	扌勹丶丿一丨
椤	木罒丿ㄋ丶丶
啮	口齿丨一丨一
畿	幺幺一ㄋ丿丶
镣	钅大丶丿丨ㄋ
骁	马尧一ㄋ丿一
掸	扌单丶丿丨ㄋ
侗	亻冂一丨ㄋ一
椽	木彑丿ㄋ丿丿
泓	氵弓ㄋ丶丶丶
酯	酉匕丨ㄋ一一
滦	氵亦一丨丿丶
蚱	虫乍丿一丨一
荩	艹尺丶丶丶丶
癜	疒尸一丨丨一
歆	音欠丿ㄋ丿丶
癸	癶天一一丿丶
蹶	厂丶丿一ㄋ
扪	扌门丶丨ㄋㄋ
蚜	虫牙一ㄋ丨丿
蝮	虫丨ㄋ一一
庑	广一一丿ㄋㄋ
弈	亦廾一丿丨丨
庋	广十ㄋ丶丶丶
喟	口田丨ㄋ一一
滂	氵丶一ㄋ丿
啕	口勹丿一一丨
蛎	虫厂一ㄋ丿丿
翊	立羽ㄋ丶一ㄋ
龊	齿口丨一丿丶
槁	木丨ㄋ一一
獭	犭束丿ㄋ丨ㄋ
莘	艹辛丶一丶丿
邺	业阝ㄋ丨丨丨
燮	言火丶丿丿丶
铛	钅ㄋ一一一
剁	几木丨丨丨丨
觐	堇见丨ㄋ丿ㄋ
谗	讠丿ㄋ丶丶
臃	月亠ㄋㄋ丿丿
镍	钅自一丨丿丶
晔	日化一丨丨丨
墒	土丨ㄋ一丨
燔	火釆丨ㄋ一丨
嘭	口壴丿丿丿丿
涿	氵豕丶丶丶丶
醯	酉丿丨ㄋ丨
箩	罒丿ㄋ丶丶
睨	目臼丿ㄋㄋㄋ
鄱	釆田ㄋ丨丨丨
鹭	各丿ㄋ丶ㄋ
坳	土幺ㄋ丿丿丿
砷	石日丨丨丨丨
诤	讠争丿ㄋㄋ一
唏	口乂一丿丨ㄋ
蚩	屮一丨ㄋ一丨
琥	王虍丿ㄋㄋㄋ
猬	犭田丨ㄋ一一
殁	歹殳丿ㄋㄋ丶
伲	亻尸丿ㄋㄋㄋ
泾	氵轻ㄋ丶一丨
缥	纟覀一一丨丿
殓	歹亼丶丶丿一
鳅	鱼禾丶丿丿丶
芷	艹止丨一丨一
舫	舟方丶一ㄋ丿
逅	丶ㄋ丶丶
嶙	山米丿ㄋ丶一
诋	讠氏丶丶丶丶
刍	刍丿ㄋㄋ一一
氰	气青一一丨一
唰	口尸丨ㄋ丨丨
呓	口艹ㄋㄋㄋㄋ
茁	艹屮ㄋ丨丨丨
骧	马亠丨ㄋ一丨
馑	饣堇一丨丨一
妫	女丶ㄋ丿丶丶
袂	衤丿丶丶丶
峋	山勹丨ㄋ一一
苷	艹甘一丨丨一
擢	扌羽丿丨丶一
懑	氵艹一丨ㄋ丿
蓑	艹一丿ㄋ丿
踹	山一丿丨ㄋ
祉	礻止丨一丨一
涞	氵夹丨丿丶丶
沏	氵七ㄋ丿丿丿
掇	扌双ㄋ丶ㄋ丶
噫	口音丶ㄋ丶丶
诳	讠犭一一丨一
饽	饣ㄋ丨一一
绺	纟夂丨丶丶丶
饪	饣壬丿一丨一
谘	讠次丨ㄋ一一
迳	轻辶丶ㄋ丶丶
飧	夕食丿丶丶ㄋ
铡	钅贝丨丨丨丨
枞	木从丿丶丿丶
熨	尸示一丨丶丶
鋈	氵夭丿丶一一
荭	艹纟一丨一一
赊	贝人一一丨丿
戛	丆目一ㄋ丿丶
俦	亻一丨丶丶
幺	幺ㄋㄋ丶丶丶
湎	氵面一丿丨ㄋ
龌	齿尸一ㄋ丶一
芪	艹氏丿ㄋ一ㄋ
觯	角单丶丿丨ㄋ
凇	冫木丿丶ㄋ丶
嬴	赢女ㄋ丿一一
挞	扌大丶ㄋ丶丶
嘁	口戊丨一一一
苻	荷寸一丨丶丶
鞯	革艹一丿丨ㄋ
肽	月大丶丶丶丶
恸	忄云ㄋ丿丿丿
钰	钅王丶丶丶丶
迨	厶口丶ㄋ丶丶
儆	亻艹丿ㄋ丨ㄋ
讫	讠ㄋㄋㄋㄋ
觎	亼⺝丨丨丨ㄋ
僮	亻立丨ㄋ一一
龇	齿此丨一丨一
滓	氵宀丶一丶丿
媾	女丨ㄋ一丨
涮	氵尸丨ㄋ丨丨
胯	月大一一ㄋㄋ
绾	纟宀丨ㄋ一ㄋ
赳	走丩ㄋ丨丨丨
斛	角⺀一丨丨丨
杈	木又丶丶丶丶
觥	角光丨丶丿一
疸	疒旦丨ㄋ一一
卞	丶下一丨丶丶
愠	忄日丨ㄋ丨丨
烨	火化一丨丨丨
庠	广羊丶丿一一
拮	扌吉一丨一丨
龢	合吅丨ㄋ一丨
窈	穴幺ㄋ丿丿丿
菠	落皮ㄋ丿丨ㄋ
罄	士丿ㄋㄋ丶
腴	月臼丿丶丶丶
弁	厶廾一丿丨丨
囤	囗屯一ㄋ丨ㄋ
咣	口光丨丶丿一
奘	爿士一丿丶丶
缫	纟巛丨ㄋ一一
缈	纟目丨丿丶丿
潢	氵丨ㄋ一丨
喵	口艹丨ㄋ一丨
柚	木由丨ㄋ一丨
遛	田丶ㄋ丶丶
藜	艹禾丿ㄋㄋㄋ
荻	艹犭丶丿丿丶
琨	王日一ㄋ丿ㄋ
郏	夹人ㄋ丨丨丨
镳	钅鹿丶丶丶丶
雉	矢隹丿丨丶一
橐	石一丨丿丶
艮	艮ㄋ一一ㄋ丿
骈	马䒑一丿丨丨
蛉	虫令丿丶丶ㄋ
濡	氵一丿丨ㄋ
搽	扌艹丿丶一丨
柩	木匚丿ㄋ丶丶
寮	宀大丶丿丨ㄋ
啷	口丶ㄋ一一ㄋ
佗	亻宀丿ㄋㄋㄋ
诜	讠先丿一丨一
偻	亻米ㄋ丿一一
夯	大力ㄋ丿丿丿
闱	门韦一一ㄋ丨
筠	土丿ㄋ丶一
虻	虫亡丶一ㄋㄋ
夥	日木丿ㄋ丶丿
枸	木勹丨ㄋ一一
膑	月宀丿丨一丨
谖	讠爫一一丿ㄋ
臾	臼人丿丶丶丶
笞	厶丨ㄋ一一
埽	土彐丶ㄋ丨ㄋ
婀	女阝一丨ㄋ一
珞	王各丿ㄋ丶丨
粑	米巴ㄋ丨一ㄋ
殒	歹口丨ㄋ丿丶
觊	山己丨ㄋ丿ㄋ
怵	忄木丶丶丶丶
崂	山ㄋ丿丿丿
绻	纟ㄋㄋㄋㄋ
昱	日立丶一丶丿
颧	艹吅丿丨丶一
榛	木一丨丿丶
嗑	口去丨ㄋ丨丨
蜴	虫日丿ㄋ丿丿
鳝	鱼羊丶丿一丨
噙	口人丶一丿丶
淼	水水丨ㄋ丿丶
矾	石几丶丶丶丶
囿	囗丨ㄋ一一
硼	石月丿ㄋ一一
邂	角刀丿一一丨
蠹	石丨ㄋ一丨
钜	钅匚ㄋ一一一
泅	氵囗丿丶丶丶
垩	亚土一丨一一
嗝	口鬲一丨ㄋ一
乩	占乚ㄋㄋㄋㄋ
淦	氵金丿丶一一
樽	木酋一丨丶丶
诮	讠丨ㄋ一一
啐	口亠丿丶丿丶
淅	氵木丿丿一丨
揆	扌癶一一丿丶
榉	木丿丶一一
辔	纟车ㄋㄋ一丨
骛	矛攵ㄋㄋ一一
鱿	鱼尢丶丶丶丶
暹	日隹丶ㄋ丶丶
馗	九䒑丿丨ㄋ一
獠	犭大丶丿丨ㄋ
犷	犭广丶一丿丿
竦	立束一丨ㄋ一
苫	艹占丨一丨ㄋ
詈	罒言丶一一一
篙	丨ㄋ一一
诨	讠冖一ㄋ一丨
滢	氵一一丨一
峒	山冂一丨ㄋ一
蜚	非虫丨ㄋ一丨
馄	饣日一ㄋ丿ㄋ
铰	钅六丿丶丶丶
靓	青见丨ㄋ丿ㄋ
琬	王宀丿ㄋ丶ㄋ
璨	王⺊丿ㄋ丶丿
犟	弓口丨ㄋ一丨
狻	犭厶丿丶丿ㄋ
螨	虫艹一丨ㄋ丿
鸬	⺊尸丿ㄋ丶ㄋ
嘹	口大丶丿丨ㄋ
芩	艹今丿丶丶ㄋ
锟	钅日一ㄋ丿ㄋ
蜇	折虫丨ㄋ一丨
栉	木艹ㄋ丨丨丨
洹	氵一丨ㄋ一一
俪	亻丽一丨ㄋ丶
钍	钅土一丨一一
瑁	王日丨ㄋ一一
锨	钅斤丿ㄋ丿丶
壹	豆一丨ㄋ一
痿	疒禾ㄋ丿一一
竑	立ㄋ丶丶丶
犄	牜大一丨ㄋ一
粕	米白丿丨ㄋ一
瘙	疒又丶丨ㄋ一
衲	衤内丨ㄋ丿丶
饯	饣戋一一ㄋ丿
抟	扌二ㄋ丶丶丶
踮	广丨一丨ㄋ
龅	齿勹ㄋ一ㄋㄋ
馥	禾日丿一丨ㄋ
愎	忄丨ㄋ一一
梏	木告丿一丨一
邝	广阝ㄋ丨丨丨
讣	讠卜丨丶丶丶
鲟	鱼彐一丨丶丶
趺	夫一一丿丶
艿	艹乃ㄋ丿丿丿
绉	纟刍丿ㄋㄋ一
剜	宀夕ㄋㄋ丨丨
罅	缶虍丿丶丿一
笥	一丨ㄋ一
衩	衤又丶丶丶丶
姣	女六丿丶丶丶
斫	石斤丿丿一丨
鹗	吅二ㄋ丿ㄋ丶
窕	穴儿丶一丿丶
猕	犭弓丿ㄋ丨丿
爻	乂乂丿丶丶丶
晗	日今丨ㄋ一一
铩	钅乂一丨丿丶
搡	扌又ㄋ丶ㄋ丶
崴	山戊一ㄋ丿一
仨	亻三一一一一
酢	酉乍丿一丨一
璀	王山丿丨丶一
佞	亻二ㄋ丿一一
檄	木白丶一ㄋ丿
岷	山民ㄋ一ㄋ一
邕	巛口ㄋ丨一ㄋ
舛	夕㐄一ㄋ丨丨
闿	门山ㄋ一ㄋㄋ
霁	文丿丨丨丨
铂	钅白丿丨ㄋ一
犒	牜丨ㄋ一一
麒	鹿其一丨丨一
阈	门戈丨ㄋ一一
馏	饣丨ㄋ一丨
麋	鹿米丶丿一丨
妍	女开一一丿丨
涔	氵山丿丶丶ㄋ
摁	扌因丶ㄋ丶丶
宥	宀丨ㄋ一一
铤	钅壬ㄋ丶丶丶
锷	钅吅一一ㄋㄋ
苁	艹从丿丶丿丶
嗲	口父丿ㄋ丶丿
恽	忄冖一ㄋ一丨
麂	鹿几丿ㄋㄋㄋ
胛	月甲丨ㄋ一一
赝	厂亻丿丨丶一
哂	口西一丨ㄋ丿
噘	口厂丶丿一ㄋ
呶	口女ㄋ丶丶丶
飨	丿丿丶丶ㄋ
撷	扌吉一丿丨ㄋ
栎	木丨丿丶丶
懔	忄亠丨ㄋ丨ㄋ
桎	木至一ㄋ丶一
霰	丨ㄋ一一
娣	女弟丶丿ㄋ一
揄	扌亼丨ㄋ一一
噔	口癶一丨ㄋ一
咤	口宀丿一ㄋㄋ
忝	天丨丶丶丶
薏	艹音丶ㄋ丶丶
贲	十艹丨ㄋ丿丶
迤	也丶ㄋ丶丶
泸	氵⺊ㄋ一丿丿
嗵	口甬丶ㄋ丶丶
胪	月⺊ㄋ一丿丿
鍪	矛攵丿丶一一
咿	口亻ㄋ一一丿
鹌	大日ㄋ丿ㄋ丶
蔫	艹正ㄋ一丶丶
僖	亻壴丨ㄋ一一
刈	乂刂丨丨丨丨
嗪	口一丨丿丶
铨	钅人一一丨一
嵘	山一丨丿丶
岫	山由丨ㄋ一丨
茏	艹龙一丿ㄋ丿
茯	荷犬一丿丶丶
怼	又寸丶ㄋ丶丶
轱	车十丨ㄋ一一
昕	日斤丿丿一丨
郢	口王ㄋ丨丨丨
咩	口羊丶丿一一
馊	饣臼丨ㄋ丶丶
澧	氵曲一丨ㄋ一
髡	髟一丿ㄋㄋㄋ
濯	氵羽丿丨丶一
盥	水丨ㄋ丨丨
苣	艹匚ㄋ一一一
囡	囗女ㄋ丿一一
砺	石厂一ㄋ丿丿
佘	人示一一丨丿
翦	前羽ㄋ丶一ㄋ
弑	乂朩一ㄋ丶一
楂	木木丨ㄋ一一
谶	讠从一ㄋ丿丶
霏	非丨一一一
怩	忄尸丿ㄋㄋㄋ
楹	木乃ㄋ丶丨ㄋ
蠼	虫目丨ㄋ一一
讴	讠区一丿丶ㄋ
锲	钅丰ㄋ丿丿丿
慵	忄广ㄋ一一丨
砭	石丿丶ㄋ丶丶
胝	月氏丶丶丶丶
杵	木一丨丨丨
潍	氵纟丿丨丶一
樾	木走一ㄋㄋ丿
帼	巾囗一一丨一
碣	石日丿ㄋ丿丶
裟	氵少丶一丿ㄋ
诌	讠刍丿ㄋㄋ一
胴	月冂一丨ㄋ一
啶	口定丶丶ㄋ一
徕	彳夹丨丿丶丶
钴	钅古一丨丨ㄋ
楫	木口一丨丨一
赭	赤者一丨一丿
铣	钅先丿一丨一
铱	钅衣丶一丿ㄋ
酊	酉丁一丨丨丨
魑	鬼㐫丨ㄋㄋ丶
醛	酉艹丿丶一一
碛	石丨ㄋ丿丶
剐	口内丨丨丨丨
陂	阝皮ㄋ丿丨ㄋ
畦	田圭一丨一一
阄	门丨ㄋ一一
闶	门亠丿ㄋㄋㄋ
祚	礻乍丿一丨一
鹘	骨鸟丿ㄋ丶ㄋ
骅	马化一丨丨丨
泱	氵冂一丿丶丶
趄	走且丨ㄋ一一
陲	阝垂丿一丨一
倜	亻冂一丨一丨
燧	火丷一丿ㄋ丿
呤	口令丿丶丶ㄋ
铉	钅亠ㄋㄋ丶丶
郧	口贝ㄋ丨丨丨
粲	⺊夕ㄋ丶丶丿
骶	骨氏丶丶丶丶
髭	髟此丨一丨一
忸	忄丑ㄋ丨一一
骞	寒马ㄋㄋ一一
渌	氵丨ㄋ丿丶
戡	其乚一ㄋ丿丶
峁	山卯丿ㄋ丿ㄋ
谲	讠矛丨ㄋ丿丶
锃	钅口一一丨一
苋	艹见丨ㄋ丿ㄋ
钨	钅勹ㄋ一一一
蜊	虫禾丨丨丨丨
骊	马丽一丨ㄋ丶
幄	巾尸一ㄋ丶一
戕	爿戈一ㄋ丿丶
闼	门大丶ㄋ丶丶
虢	爫寸丨一ㄋ丿
妲	女旦丨ㄋ一一
袈	加衣丶一丿ㄋ
烩	火人一一ㄋ丶
傥	亻丿ㄋㄋㄋ
桠	木亚一丨丨丶
绌	纟屮ㄋ丨丨丨
揿	扌钅丿ㄋ丿丶
薮	艹米ㄋ丿一丿
肓	亡⺝丨ㄋ一一
杲	日木一丨丿丶
氤	气因丨ㄋ一丿
莅	荷立丶一丶丿
厝	厂龷丨ㄋ一一
缙	纟亚丨ㄋ一一
衮	六厶丿ㄋ丿丶
旖	族大一丨ㄋ一
诟	讠一丨ㄋ一
硒	石西一丨ㄋ丿
颦	止一丿丨ㄋ
裱	衤丿ㄋ丿丶
唁	口言丶一一一
嬗	女亠丨ㄋ丨ㄋ
硎	石开一一丿丨
靥	厂犬一丿丨ㄋ
礴	石落一丨ㄋ一
煨	火田一一一一
鏖	鹿金丿丶一一
纥	纟ㄋㄋㄋㄋ
羿	羽廾一丿丨丨
笏	勿丿ㄋ丿丿
蝈	虫囗一一丨一
炜	火韦一一ㄋ丨
煲	亻呆丶丿丿丶
锉	钅从一丨一一
湟	氵白一一丨一
甑	曾瓦一ㄋㄋ丶
鼐	乃目ㄋ一丿丨
笕	见丨ㄋ丿ㄋ
妪	女区一丿丶ㄋ
嶂	山音一丨丨丨
弭	弓耳一丨丨一
浔	氵彐一丨丶丶
喑	口音丶一丶丿
锂	钅里丨ㄋ一一
颏	亥页一丿丨ㄋ
醴	酉曲一丨ㄋ一
孳	䒑幺ㄋㄋ丶ㄋ
苡	艹以ㄋ丶丿丶
渚	氵者一丨一丿
轭	车厂ㄋㄋㄋㄋ
蚝	虫毛丿一一ㄋ
鹬	矛冂丿丶丨ㄋ
耦	耒日丨ㄋ丨一
覃	覀日一丨丨丨
膘	月覀一一丨丿
痨	疒ㄋ丿丿丿
褡	衤艹丿丶一丨
邛	工阝ㄋ丨丨丨
馔	饣巳ㄋ一ㄋ一
篾	罒一丿ㄋ丿
兖	六厶丿ㄋㄋㄋ
遨	敖辶丶ㄋ丶丶
艄	舟丨ㄋ一一
爰	爫一一丿ㄋ丶
痂	疒加ㄋ丿丨ㄋ
阋	门臼丿ㄋㄋㄋ
耨	耒辰一丨丶丶
邋	巛囗丿丶ㄋ丶
昶	丶㇉ㄋ丿丶丨
秣	禾未丨丿丶丶
沤	氵区一丿丶ㄋ
焓	火今丨ㄋ一一
俎	从且丨ㄋ一一
绦	纟夂一丨丿丶
窣	穴亠丿丶丿丶
榫	木隹一丨丨丨
蟪	虫一丨ㄋ一一
烃	火轻ㄋ丶一丨
稗	禾卑丿丨ㄋ一
锴	钅比丿丨ㄋ一
龉	齿五丨ㄋ一一
謇	寒言丶一一一
氩	气亚一丨丨丶
嬷	女麻丿ㄋ丶丶
鸢	弋鸟丿ㄋ丶ㄋ
肱	月ㄋ丶丶丶
痤	疒从一丨一一
笫	弟丶丿ㄋ一
俣	亻口一一丿丶
阕	门癶一一丿丶
莆	艹甫一丨ㄋ一
鼹	鼠日丶丶ㄋㄋ
菏	落可一丨ㄋ一
碜	石丿丿丿丿
砣	石宀丿ㄋㄋㄋ
芨	艹及丿ㄋ丶丶
猷	酋犬一丿丶丶
舸	舟可一丨ㄋ一
竽	于一一丨丨
诓	讠匚一一丨一
錾	车斤丿丶一一
婕	女一ㄋ一一丨
淬	氵亠丿丶丿丶
邈	豸白丿ㄋ丶ㄋ
姘	女䒑一丿丨丨
隗	阝鬼丿丨ㄋ一
悌	忄弟丶丿ㄋ一
槭	木戊丨一一丨
稹	禾直丿丶丶丶
蹴	京一丿ㄋ丶
歙	合羽丿ㄋ丿丶
豕	豕一丿ㄋ丿丿
羯	日丿ㄋ丿丶
砒	石比一ㄋ丿ㄋ
痈	疒用丿ㄋ一一
镏	钅丨ㄋ一丨
鲂	鱼方丶一ㄋ丿
蓖	艹丿丶一一
笤	刀丨ㄋ一一
匦	匚车丿ㄋㄋㄋ
峥	山争丿ㄋㄋ一
浃	氵夹丿丶丶丶
烊	火羊丶丿一一
徭	彳爫丿一一丨
翳	匚矢丿ㄋㄋ丶
褓	衤亻丨ㄋ一一
缢	纟䒑丿丶丨ㄋ
趔	走歹丨丨丨丨
酆	山丰一一一丨
蚨	虫夫一一丿丶
窸	穴釆丶ㄋ丶丶
泷	氵龙一丿ㄋ丿
仃	亻丁一丨丨丨
勖	日目ㄋ丿丿丿
誊	言丶一一一
炔	火丿丶丶丶
葺	艹口一丨丨一
蚴	虫幺ㄋ丿丿丿
赜	丨ㄋ丿丶
蛴	虫文丿丨丨丨
媸	女屮一丨ㄋ一
孱	尸子ㄋ丨一ㄋ
逡	厶八丿ㄋ丶丶
俳	亻非丨一一一
砦	此石一丿丨ㄋ
祜	礻古一丨丨ㄋ
跸	比一丨丨丨
诖	讠圭一丨一一
茑	艹鸟丿ㄋ丶ㄋ
飚	几乂丶丿丿丶
屐	尸彳一丨ㄋ丶
溴	氵自一丿丶丶
伉	亻亠丿ㄋㄋㄋ
蛞	虫舌丿一丨丨
崆	山穴一丨一一
鸨	匕十丿ㄋ丶ㄋ
庾	广臼丿丶丶丶
掮	扌户丨ㄋ一一
蒯	艹月丿ㄋ一一
圻	土斤丿丿一丨
橛	木厂丶丿一ㄋ
矸	石干一一丨丨
缂	纟革一丨丨一
鸪	古鸟丿ㄋ丶ㄋ
啭	口车一一ㄋ丶
蛩	工几丶丨ㄋ一
蠖	虫艹丿丨丶一
镉	钅鬲一丨ㄋ一
饧	饣㇡丿丿丿丿
诹	讠耳ㄋ丶丶丶
劭	刀口ㄋ丿丿丿
遑	白王丶ㄋ丶丶
棂	木彐丶丿丿丶
螫	赤攵丨ㄋ一丨
哐	口匚一一丨一
杼	木予ㄋ丶ㄋ丨
颢	日京一丿丨ㄋ
崧	山木丿丶丶丶
龃	齿且丨ㄋ一一
饔	亠丿丿丨丶
襁	衤弓丨ㄋ一丨
腱	月聿ㄋ丶丶丶
濠	氵一丿ㄋ丿
牝	牜匕丿ㄋㄋㄋ
忾	忄气丿一一ㄋ
鲆	鱼平一丶丿一
蛄	虫古一丨丨ㄋ
嗄	口丆丨ㄋ一一
灏	氵日丶一丨ㄋ
荞	艹夭丿丨丨丨
苜	艹目丨ㄋ一一
嘣	口山丿ㄋ一一
疥	疒人丿丨丨丨
夤	夕宀一丿丶丨
颞	耳双一丿丨ㄋ
砝	石去一丨一ㄋ
辇	夫夫一ㄋ一丨
遢	日羽丶ㄋ丶丶
忤	忄一丨丨丨
旎	族尸丿ㄋㄋㄋ
魉	鬼丙丿丶丿丶
瘛	疒丰ㄋ丿丶ㄋ
荥	水丨ㄋ丿丶
毂	车丿ㄋㄋ丶
娌	女里丨ㄋ一一
涫	氵宀丨ㄋ一ㄋ
碇	石定丶丶ㄋ一
瓤	亠吅一一丨丨
氚	气川丿丨丨丨
臁	月广丶丿一ㄋ
玮	王韦一一ㄋ丨
羟	轻ㄋ丶一丨
吡	口比一ㄋ丿ㄋ
壅	亠丿丿丨丶
缛	纟辰一丨丶丶
毖	比心丿丿丿丿
珈	王加ㄋ丿丨ㄋ
颀	斤页一丿丨ㄋ
虼	虫ㄋㄋㄋㄋ
珏	王王丶丶丶丶
翕	合羽ㄋ丶一ㄋ
佝	亻勹丨ㄋ一一
遴	米夕一ㄋ丨丶
祇	礻氏丿ㄋ一ㄋ
郛	爫孑ㄋ丨丨丨
玖	王久丿ㄋ丶丶
粽	米宀一一丨丿
蹇	寒口丨一丿丶
氅	冂丨ㄋ一丿
逋	甫辶丶ㄋ丶丶
诂	讠古一丨丨ㄋ
聒	耳舌丿一丨丨
髁	骨日一丨丿丶
岢	山可一丨ㄋ一
黍	禾人丨丶一丿
闳	门ㄋ丶丶丶
鞣	革矛一丨丿丶
髋	骨宀一丨丨丨
淝	氵月ㄋ丨一ㄋ
潆	氵ㄋㄋ丶丨
鲎	鱼丿ㄋ丨ㄋ
芾	艹一丨ㄋ丨丨
汨	氵日丨ㄋ一一
胍	月瓜丿丿ㄋ丶
戬	亚日一ㄋ丿丶
鬈	髟ㄋㄋㄋㄋ
铵	钅宀ㄋ丿一一
鹜	矛攵丿ㄋ丶ㄋ
钤	钅今丿丶丶ㄋ
阏	门方丿丶丶丶
衾	今衣丶一丿ㄋ
脍	月人一一ㄋ丶
畲	人示丨ㄋ一丨
枰	木平一丶丿一
樯	木十丶丿一丨
蹼	业丶丿一一
崮	山囗一丨丨ㄋ
洱	氵耳一丨丨一
咭	口吉一丨一丨
囫	囗勿丿ㄋ丿丿
劬	勹口ㄋ丿丿丿
刎	勿刂丨丨丨丨
鳕	鱼ㄋ一一一
琊	王牙ㄋ丨丨丨
碚	石立丨ㄋ一一
芏	艹土一丨一一
恂	忄勹丨ㄋ一一
谪	讠丨ㄋ丿丶
槿	木堇一丨丨一
嘧	口宀丶ㄋ丶丿
绀	纟甘一丨丨一
鲧	鱼丿ㄋㄋ丶丨
芎	艹弓ㄋ一ㄋㄋ
鲢	鱼车丶ㄋ丶丶
潸	氵林丨ㄋ一一
鲶	鱼今丶ㄋ丶丶
噱	口虍一丿ㄋ丿
郦	丽阝ㄋ丨丨丨
浠	氵乂一丿丨ㄋ
跏	加ㄋ丿丨ㄋ
琰	王火丶丿丿丶
抻	扌日丨丨丨丨
臬	自木一丨丿丶
矍	目目丿丨丶一
鹚	䒑幺ㄋㄋ丶丿
苌	艹长丿一ㄋ丶
龆	齿刀丨ㄋ一一
觞	角ㄋ丿丿丿
雒	各隹丿丨丶一
呔	口大丶丶丶丶
芄	艹九丶丶丶丶
阒	门目一丿丶丶
槎	木一丨一一
舂	臼丿丨一ㄋ
鸩	冖儿丿ㄋ丶ㄋ
钒	钅几丶丶丶丶
饫	饣夭丿一丿丶
阡	阝千丿一丨丨
稔	禾今丶ㄋ丶丶
莒	艹口丨ㄋ一一
萸	艹臼丿丶丶丶
穰	禾亠丨ㄋ一丨
蚧	虫人丿丨丨丨
餍	厂犬丿丶丶ㄋ
妗	女今丿丶丶ㄋ
谠	讠丿ㄋㄋㄋ
葩	艹白ㄋ丨一ㄋ
谯	讠隹丶丶丶丶
菸	艹方丿丶丶丶
芗	艹丿丿丿丿
踔	⺊丨ㄋ一一
佻	亻儿丶一丿丶
倨	亻尸一丨丨ㄋ
钏	钅川丿丨丨丨
黩	黑十ㄋ丶丶一
饩	饣气丿一一ㄋ
嘌	口覀一一丨丿
厣	厂犬丨ㄋ一一
蠓	虫一一丿ㄋ
恁	亻壬丶ㄋ丶丶
钿	钅田丨ㄋ一丨
殚	歹单丶丿丨ㄋ
藿	艹丿丨丶一
鎏	氵丿丨ㄋㄋ
缬	纟吉一丿丨ㄋ
瓯	区瓦一ㄋㄋ丶
酩	酉夕丨ㄋ一一
旃	族冂丶一一一
呋	口夫一一丿丶
婺	矛攵ㄋ丿一一
鄣	音十ㄋ丨丨丨
囟	㐅一一一一
锶	钅田丶ㄋ丶丶
绱	纟丨ㄋ丨ㄋ
恹	忄厂一丿丶丶
缦	纟日丨ㄋ丨丨
逶	禾女丶ㄋ丶丶
鸹	舌鸟丿ㄋ丶ㄋ
邬	勹㇉一ㄋ丨丨
殇	歹ㄋ丿丿丿
媪	女日丨ㄋ丨丨
阗	门直丿丶丶丶
鲛	鱼六丿丶丶丶
篑	丨ㄋ丿丶
讦	讠干一一丨丨
螟	虫冖丨ㄋ一一
醪	酉羽丿丶丿丿
菟	艹丿ㄋ丶丶
濉	氵目丿丨丶一
峤	山夭丿丨丨丨
芡	艹欠丿ㄋ丿丶
鄯	羊䒑丨ㄋ一ㄋ
肼	月井一一丿丨
嫠	未攵一丿ㄋ丿
愆	彳氵一一丨丶
掼	扌毌丨ㄋ丿丶
焖	火门丶ㄋ丶丶
聩	耳丨ㄋ丿丶
岘	山见丨ㄋ丿ㄋ
讧	讠工一丨一一
矽	石夕丿ㄋ丶丶
靛	青定丶丶ㄋ一
挈	丰刀丿一一丨
杷	木巴ㄋ丨一ㄋ
笳	加ㄋ丿丨ㄋ
姒	女以ㄋ丶丿丶
菖	艹日丨ㄋ一一
卟	口卜丨丶丶丶
蚋	虫内丨ㄋ丿丶
袢	衤半丶丿一一
砉	丰石一丿丨ㄋ
踽	丿丨ㄋ一丨
黾	口日ㄋㄋㄋㄋ
挲	氵少丿一一丨
凫	几丿ㄋㄋㄋ
侩	亻人一一ㄋ丶
莜	艹丿一丿丶
鼋	元口丨ㄋ一一
韪	是韦一一ㄋ丨
郯	火火ㄋ丨丨丨
笪	旦丨ㄋ一一
诔	讠耒一一一丨
箸	者一丨一丿
菅	艹宀丨ㄋ一ㄋ
裢	衤车丶ㄋ丶丶
趿	及丿ㄋ丶丶
嵊	山禾丨一一丿
圜	囗罒一丨ㄋ一
赍	十从丶ㄋ丨ㄋ
涪	氵立丨ㄋ一一
莠	艹禾ㄋ丿丿丿
莴	艹口丨ㄋ丿丶
旯	日九丿ㄋㄋㄋ
阌	门ㄋ丶丶丶
巽	巳巳一丨丨一
跎	宀丿ㄋㄋㄋ
囵	囗仑丿丶丿ㄋ
簟	覀丨ㄋ一一
柞	木乍丿一丨一
曷	日勹丿丶ㄋㄋ
榧	木匚丨一一一
裰	衤双ㄋ丶ㄋ丶
笾	力丶ㄋ丶丶
嗍	口屰丿ㄋ一一
绔	纟大一一ㄋㄋ
餮	歹人丿丿丿丿
讵	讠匚ㄋ一一一
魃	鬼ㄋ丶丶丶
骓	马隹丿丨丶一
逖	犭火丶ㄋ丶丶
镒	钅䒑丿丶丨ㄋ
枋	木方丶一ㄋ丿
踅	折口丨一丿丶
鄢	正与丶丶丶丶
瑭	王广ㄋ一一丨
乜	乚ㄋㄋㄋㄋ
鳟	鱼酋一丨丶丶
荛	艹尧一ㄋ丿一
馓	饣丨ㄋ一一
蟛	虫壴丿丿丿丿
忪	忄公丿丶ㄋ丶
纰	纟比一ㄋ丿ㄋ
姹	女宀丿一ㄋㄋ
桉	木宀ㄋ丿一一
阍	门氏丨ㄋ一一
氘	气丿丨丨丨
氪	气古丿ㄋㄋㄋ
娉	女由一ㄋㄋㄋ
纡	纟于一一丨丨
缟	纟丨ㄋ一一
旮	九日丨ㄋ一一
垅	土龙一丿ㄋ丿
汊	氵又丶丶丶丶
傈	亻覀一丨丿丶
郃	合阝ㄋ丨丨丨
镢	钅厂丶丿一ㄋ
蔺	艹门丿丨丶一
魍	鬼冂丶丿一丶
腭	月吅一一ㄋㄋ
槊	屰月一丨丿丶
缁	纟巛丨ㄋ一丨
鹕	古月丿ㄋ丶ㄋ
髂	骨宀丿ㄋ丶丨
枥	木厂ㄋ丿丿丿
庥	广亻一丨丿丶
笮	乍丿一丨一
堋	土月丿ㄋ一一
跞	丨丿丶丶
吒	口丿一ㄋㄋㄋ
蜍	虫亼一丨丿丶
鹧	度灬丿ㄋ丶ㄋ
醚	酉米丶ㄋ丶丶
禳	礻亠丨ㄋ一丨
枳	木口丿丶丶丶
舻	舟⺊ㄋ一丿丿
鏊	敖金丿丶一一
搿	合丿一一丨
钹	钅ㄋ丶丶丶
珩	王彳一一丨丨
蒺	艹疒丿一一丿
蜢	虫子丨ㄋ丨丨
鬻	弓米ㄋ一ㄋ一
骠	马覀一一丨丿
菀	艹宀丿ㄋ丶ㄋ
垭	土亚一丨丨丶
瘘	疒米ㄋ丿一一
苄	艹丶一丨丶丶
苕	艹刀丨ㄋ一一
跹	千丶ㄋ丶丶
卮	一ㄋㄋㄋㄋ
袷	衤合丿丶一丨
磬	士丿ㄋㄋ丶
鸷	执鸟丿ㄋ丶ㄋ
缶	缶丿一一丨ㄋ
笸	匚丨ㄋ一一
纨	纟九丶丶丶丶
琮	王宀一一丨丿
蕲	艹单丿丿一丨
牦	牜毛丿一一ㄋ
阆	门丶ㄋ一一ㄋ
郓	冖车ㄋ丨丨丨
蠲	䒑八丨ㄋ丨丨
锒	钅丶ㄋ一一ㄋ
芰	艹十ㄋ丶丶丶
锕	钅阝一丨ㄋ一
砩	石弓丿丨丨丨
驷	马口丿ㄋㄋㄋ
舢	舟山丨ㄋ丨丨
妯	女由丨ㄋ一丨
趸	万口丨一丿丶
鹩	大丷丨ㄋ一一
蠊	虫广丶丿一ㄋ
芫	艹元丿ㄋㄋㄋ
笊	爪丿丿丨丶
嗉	口ㄋㄋ丶丨
焱	火火丶丿丿丶
枇	木比一ㄋ丿ㄋ
饴	饣厶丨ㄋ一一
阃	门囗一丨丿丶
莸	艹犭一丿ㄋㄋ
浯	氵五丨ㄋ一一
擤	扌自丨ㄋ一丨
铆	钅卯丿ㄋ丿ㄋ
柢	木氏丶丶丶丶
醢	酉丨ㄋ一丨
呲	口此丨一丨一
牖	片户一丨ㄋ一
鬣	髟巛丨ㄋ一丿
碓	石隹丿丨丶一
帙	巾丿一一丿丶
堀	土尸ㄋ丨丨ㄋ
溆	氵亼一丨丿丶
潴	氵犭一丨一丿
鹆	八人丨ㄋ一丿
硪	石我丿一丨一
雱	方丶一ㄋ丿
崾	山覀ㄋ丿一一
箝	扌一丨丨一
幂	冖日一丿丶丶
獐	犭音一丨丨丨
桁	木彳一一丨丨
鳏	鱼罒丨丿丿丶
郴	林阝ㄋ丨丨丨
蛱	虫夹丿丶丶丶
疝	疒山丨ㄋ丨丨
诎	讠屮ㄋ丨丨丨
僳	亻覀丶丿一丨
茴	艹回丨ㄋ丨ㄋ
呦	口幺ㄋ丿丿丿
揶	扌耳ㄋ丨丨丨
囹	囗令丿丶丶ㄋ
脲	月尸丨ㄋ丿丶
螈	虫厂丿丨ㄋ一
嗌	口䒑丿丶丨ㄋ
贽	执贝丨ㄋ丿丶
痼	疒囗一丨丨ㄋ
镊	钅耳ㄋ丶ㄋ丶
膈	月鬲一丨ㄋ一
赅	贝亥丶一ㄋ丿
锑	钅弟丶丿ㄋ一
鳊	鱼户丨ㄋ一丨
胨	月丨丿丶丶
桡	木尧一ㄋ丿一
鼬	鼠由丨ㄋ一丨
雎	且隹丿丨丶一
鞫	革勹丶一一一
峄	山又一一丨丨
鲋	鱼亻一丨丶丶
苤	艹不一一一一
昀	日勹丶一一一
痍	疒大ㄋ一ㄋㄋ
疖	疒卩ㄋ丨丨丨
蟊	矛虫丨ㄋ一丨
熘	火丨ㄋ一丨
鞴	革丿丿ㄋ一
獯	犭千丨ㄋ丶丿
鹂	丽鸟丿ㄋ丶ㄋ
炷	火主丶一一丨
裾	衤尸一丨丨ㄋ
羸	赢羊丶丿一一
栀	木一ㄋㄋㄋ
侪	亻文丿丨丨丨
硐	石冂一丨ㄋ一
槲	木角丶丶一丨
嵴	山丿丶丨ㄋ
炝	火人ㄋㄋㄋㄋ
锸	钅千丿丨一ㄋ
乇	丿七一ㄋㄋㄋ
佰	亻一丿丨ㄋ一
哔	口比一丨丨丨
牯	牛古一丨丨ㄋ
旆	族一丨ㄋ丨丨
掾	扌彑丿ㄋ丿丿
珐	王去一丨一ㄋ
屙	尸阝一丨ㄋ一
僦	亻京一丿ㄋ丶
钪	钅亠丿ㄋㄋㄋ
仟	亻千丿一丨丨
廪	广亠丨ㄋ丨ㄋ
擘	辟手丿一一丨
跗	亻一丨丶丶
圮	土己ㄋ一ㄋㄋ
崃	山夹丨丿丶丶
芟	艹殳丿ㄋㄋ丶
鲅	鱼ㄋ丶丶丶
笱	勹丨ㄋ一一
彀	一ㄋ一ㄋ丿
硷	石亼丶丶丿一
圄	囗五丨ㄋ一一
苎	艹宀一一一一
匏	大二ㄋ丿ㄋㄋ
嗾	口族丿一一丿
赧	赤卩ㄋ丶丶丶
玳	王亻一ㄋ丶丶
掴	扌囗一一丨一
勐	子皿ㄋ丿丿丿
愍	民攵丶ㄋ丶丶
粳	米更一丨ㄋ一
畛	田人丿丿丿丿
涑	氵束一丨ㄋ一
卣	⺊囗ㄋ一一一
浞	氵口丨一丿丶
逦	丽辶丶ㄋ丶丶
箧	匚一丶丿一
铄	钅丨丿丶丶
貉	豸各丿ㄋ丶丨
湫	氵禾丶丿丿丶
椴	木段丿丨一一
擀	扌丿丶一一
刖	月刂丨丨丨丨
鲮	鱼土丿丶丿ㄋ
茱	艹丿丨丿丶丶
啖	口火丶丿丿丶
畈	田ㄋ丶丶丶
悭	忄一丨一一
訇	勹言丶一一一
愀	忄禾丶丿丿丶
朐	月勹丨ㄋ一一
鹨	羽人丿丿丿丿
蛘	虫羊丶丿一一
晟	日戊ㄋㄋㄋㄋ
佶	亻吉一丨一丨
颛	山一丿丨ㄋ
缃	纟相一丨丿丶
凼	水凵ㄋ丨丨丨
鲱	鱼非丨一一一
苴	艹且丨ㄋ一一
徉	彳羊丶丿一一
癯	疒目丨ㄋ一一
洙	氵丿丨丿丶丶
锆	钅告丿一丨一
厍	厂车一ㄋ一丨
佤	亻瓦一ㄋㄋ丶
鞒	革夭丿丨丨丨
氡	气夂丶丶丶丶
胗	月人丿丿丿丿
螭	虫㐫丨ㄋㄋ丶
钺	钅戉一ㄋㄋ丿
繇	爫缶丿ㄋㄋ丶
勰	力力ㄋ丿丨ㄋ
嵬	山鬼丿丨ㄋ一
邨	屯阝ㄋ丨丨丨
轸	车人丿丿丿丿
瘿	疒贝丨ㄋ丿丶
肫	月屯一ㄋ丨ㄋ
肟	月二ㄋㄋㄋㄋ
睇	目弟丶丿ㄋ一
仞	亻刀丶丶丶丶
蝼	虫米ㄋ丿一一
奁	大区一丿丶ㄋ
跆	厶丨ㄋ一一
轳	车⺊ㄋ一丿丿
樗	木一一ㄋㄋ
钼	钅目丨ㄋ一一
熳	火日丨ㄋ丨丨
宄	宀九丿ㄋㄋㄋ
鲰	鱼耳ㄋ丶丶丶
诶	讠厶丿一一丿
薜	艹辟ㄋ一丿丨
铧	钅化一丨丨丨
裥	衤门丨ㄋ一一
榇	木立一丨丿丶
馃	饣日一丨丿丶
怄	忄区一丿丶ㄋ
雠	隹讠丿丨丶一
鸱	氏丶丿ㄋ丶ㄋ
寤	宀爿一丨ㄋ一
虺	一儿丨ㄋ一丨
糅	米矛一丨丿丶
缗	纟民丨ㄋ一一
蹚	一丨一一
帑	奴巾丨ㄋ丨丨
矬	矢从一丨一一
硗	石尧一ㄋ丿一
镧	钅门一丨ㄋ一
碡	石ㄋㄋ丶一
悒	忄口ㄋ丨一ㄋ
啁	口冂一丨一丨
艉	舟尸丿一一ㄋ
犍	牜聿ㄋ丶丶丶
硌	石各丿ㄋ丶丨
虿	万虫丨ㄋ一丨
埙	土口丨ㄋ丿丶
锩	钅ㄋㄋㄋㄋ
蛑	虫厶丿一一丨
鼍	吅田一丨ㄋ一
筮	工丿丶丿丶
艏	舟䒑丿丨ㄋ一
肄	匕矢ㄋ一一一
糁	米丿丿丿丿
咴	口丶丿丿丶
骜	敖马ㄋㄋ一一
蜮	虫戈丨ㄋ一一
黢	黑厶丿丶丿ㄋ
砻	龙石一丿丨ㄋ
籴	入米丶丿一丨
龀	齿匕丿ㄋㄋㄋ
劢	万力ㄋ丿丿丿
鲲	鱼日一ㄋ丿ㄋ
稞	禾日一丨丿丶
鬯	㐅灬ㄋ丨丿ㄋ
畚	田丨ㄋ一丨
觳	一丿ㄋ丿ㄋ
鹁	子丿ㄋ丶ㄋ
耪	耒丶一ㄋ丿
娆	女尧一ㄋ丿一
捌	扌口ㄋ丿丨丨
柘	木石一丿丨ㄋ
篪	丨一ㄋ丿
鲀	鱼屯一ㄋ丨ㄋ
獬	犭角ㄋ丿丿一
菔	艹月ㄋ丨丨丨
闫	门三一一一一
滟	氵丰丿ㄋㄋ丨
狎	犭甲丨ㄋ一一
孬	不女ㄋ丨一一
遒	酋辶丶ㄋ丶丶
磔	石夕一ㄋ丨一
齑	文丨一一一
綦	其糸ㄋㄋ丶丨
伥	亻长丿一ㄋ丶
聃	耳冂一丨一一
谰	讠门一丨ㄋ一
鲡	鱼丽一丨ㄋ丶
谇	讠亠丿丶丿丶
鄄	覀土ㄋ丨丨丨
蔻	艹宀一一丿ㄋ
泠	氵令丿丶丶ㄋ
镫	钅癶一丨ㄋ一
钕	钅女ㄋ丿一一
砗	石车一ㄋ一丨
佥	亼丶丶丿一
躅	罒丿ㄋ丨ㄋ
螯	敖虫丨ㄋ一丨
煅	火段丿丨一一
鲠	鱼更一丨ㄋ一
菹	落且丨ㄋ一一
罘	罒不一丿丨丶
煸	火户丨ㄋ一丨
胂	月日丨丨丨丨
嶝	山癶一丨ㄋ一
坨	土宀丿ㄋㄋㄋ
灞	氵一丨丨一
踯	䒑一丿丶ㄋ
哞	口厶丿一一丨
徜	彳丨ㄋ丨ㄋ
萘	艹大一一丨丿
鸫	小丿ㄋ丶ㄋ
菽	艹上丨丿丶ㄋ
縻	麻糸ㄋㄋ丶丨
渑	氵口丨ㄋ一一
褫	衤丨一ㄋ丿
盍	去皿丨ㄋ丨丨
慊	忄兼丶丿一ㄋ
羰	山一丿丿丿
洳	氵女丨ㄋ一一
钋	钅卜丨丶丶丶
俅	亻求一丨丶一
镛	钅广ㄋ一一丨
洮	氵儿丶一丿丶
罴	罒去丶丶丶丶
怛	忄旦丨ㄋ一一
隳	阝一丨一丿
胼	月䒑一丿丨丨
芤	艹孑ㄋㄋㄋㄋ
芊	艹千丿一丨丨
膻	月亠丨ㄋ丨ㄋ
噌	口曾丶丿丨ㄋ
嫱	女十丶丿一丨
啉	口林一丨丿丶
焐	火五丨ㄋ一一
绲	纟日一ㄋ丿ㄋ
蘅	艹彳丿ㄋ丨ㄋ
亓	一丌一丿丨丨
莼	艹纟一ㄋ丨ㄋ
嘞	口革ㄋ丿丿丿
缒	纟丿丨ㄋ一ㄋ
倮	亻日一丨丿丶
镆	钅莫一丨丨丨
葎	艹彳ㄋ一一一
韫	韦日丨ㄋ丨丨
荏	荷壬丿一丨一
伧	亻人ㄋㄋㄋㄋ
鸶	一丿ㄋ丶
唳	口户一丿丶丶
蘖	艹丿丨ㄋ一ㄋ
澍	氵壴一丨丶丶
蚬	虫见丨ㄋ丿ㄋ
檩	木亠丨ㄋ丨ㄋ
颎	匕火一丿丨ㄋ
骱	骨人丿丨丨丨
羧	厶丿丶丿ㄋ
鼙	壴十ㄋ丶丿丨
焯	火⺊丨ㄋ一一
怙	忄古一丨丨ㄋ
腚	月定丶丶ㄋ一
垡	亻戈一丨一一
嘏	古叚ㄋ一丨一
魈	鬼丨ㄋ一一
亳	丿一ㄋㄋㄋ
荠	艹文丿丨丨丨
昴	日卯丿ㄋ丿ㄋ
倥	亻穴一丨一一
艽	艹九丿ㄋㄋㄋ
舨	舟ㄋ丶丶丶
粜	屮凵丶丿一丨
枵	木口一ㄋㄋㄋ
醣	酉广ㄋ一一丨
杓	木勹丶丶丶丶
茔	土一丨一一
珲	王冖一ㄋ一丨
楸	木禾丶丿丿丶
疃	田立丨ㄋ一一
髌	骨宀丿丨一丨
甙	弋甘一丨丨一
楦	木宀一丨ㄋ一
蛏	虫又一丨一一
蠛	虫萝一丿ㄋ丿
钣	钅ㄋ丶丶丶
笄	开一一丿丨
嬖	辟女ㄋ丿一一
跣	先丿一丨一
蜣	虫羊丿ㄋㄋㄋ
诼	讠豕丶丶丶丶
蜉	虫爫ㄋ丨一一
戆	音十丿ㄋ丶一
铍	钅皮ㄋ丿丨ㄋ
喾	告丿一丨一
薹	艹吉丶ㄋ一ㄋ
陉	阝轻ㄋ丶一丨
瓴	令瓦一ㄋㄋ丶
岵	山古一丨丨ㄋ
肷	月欠丿ㄋ丿丶
怫	忄弓丿丨丨丨
缯	纟曾丶丿丨ㄋ
荽	艹爫ㄋ丿一一
钭	钅⺀一丨丨丨
窀	穴屯一ㄋ丨ㄋ
帔	巾皮ㄋ丿丨ㄋ
楝	木束丶丶丶丶
摭	扌度丶丶丶丶
痱	疒非丨一一一
髑	骨罒丿ㄋ丨ㄋ
蚶	虫甘一丨丨一
倬	亻⺊丨ㄋ一一
螬	虫一丨ㄋ一丨
萋	艹一ㄋ一一丨
殛	歹了丨ㄋ一ㄋ
狷	犭口丨ㄋ一一
葭	艹叚ㄋ一丨一
衽	衤壬丿一丨一
鳢	鱼曲一丨ㄋ一
粝	米厂一ㄋ丿丿
鼗	儿一丨一丨
裉	衤艮ㄋ一一ㄋ
喁	口日丨ㄋ丨一
傧	亻宀丿丨一丨
蝽	虫丨ㄋ一一
罟	罒古一丨丨ㄋ
愦	忄丨ㄋ丿丶
裼	衤日丿ㄋ丿丿
钌	钅了ㄋ丨丨丨
嫘	女田ㄋㄋ丶丨
衿	衤今丿丶丶ㄋ
墉	土广ㄋ一一丨
锗	钅者一丨一丿
哌	口丿ㄋ丿丶
廛	广里丿丶一丨
醵	酉虍一丿ㄋ丿
跫	工几丶丨ㄋ一
粢	次米丶丿一丨
鐾	辟金丿丶一一
堇	堇一丨丨一丨
婧	女青一一丨一
蹰	厂一丨ㄋ一
陟	阝止丨丿丿丿
镞	钅族丿一一丿
扦	扌千丿一丨丨
暌	日癶一一丿丶
脘	月宀一一丿ㄋ
鳔	鱼覀一一丨丿
罱	罒十丨ㄋ丶丿
唿	口勿丶ㄋ丶丶
薨	萝冖一丿ㄋ丶
麸	夂一一丿丶
岿	山ㄋ一一一
疴	疒可一丨ㄋ一
侔	亻厶丿一一丨
郾	匚日ㄋ丿一ㄋ
砹	石艹丿丶丶丶
眦	目此丨一丨一
猢	犭古丿ㄋ一一
璎	王贝丨ㄋ丿丶
撺	扌穴丨ㄋ一丨
铳	钅丿ㄋㄋㄋ
拊	扌亻一丨丶丶
鳚	鱼尸一一丨丿
狯	犭人一一ㄋ丶
滁	氵阝丿丶一一
椁	木ㄋ丨一一
偾	亻十一丨丨丨
裎	衤口一一丨一
罾	罒曾丶丿丨ㄋ
榱	木一丿ㄋ丿
呒	口一一丿ㄋㄋ
缇	纟是丨ㄋ一一
蝣	虫族ㄋ丨一一
崞	山ㄋ丨一一
狲	犭孑丨丿丶丶
缱	纟丨ㄋ一ㄋ
冼	冫先丿一丨一
晷	日夂丨丶丶丶
痧	疒氵丨丿丶丿
萑	艹隹丿丨丶一
帏	巾韦一一ㄋ丨
蕖	落匚一ㄋㄋㄋ
疠	疒万一ㄋ丿丿
儋	亻厃丿丶丶一
窨	穴音丶一丶丿
狍	犭勹ㄋ一ㄋㄋ
绨	纟弟丶丿ㄋ一
憷	忄林ㄋ丨一丿
锛	钅大一丨一丿
袼	衤各丿ㄋ丶丨
汜	氵巳ㄋ一ㄋㄋ
邰	厶口ㄋ丨丨丨
蘩	艹ㄋㄋ丶一
窳	穴瓜丿丿ㄋ丶
瓠	大二ㄋ丿丿ㄋ
炅	日火丶丿丿丶
虮	虫几丿ㄋㄋㄋ
蚰	虫由丨ㄋ一丨
煳	火古丿ㄋ一一
嵝	山米ㄋ丿一一
庀	广匕丿ㄋㄋㄋ
泶	水丨ㄋ丿丶
蹉	一丨一一
砀	石㇡丿丿丿丿
莪	艹我丿一丨一
捩	扌户一丿丶丶
螽	夂⺀丨ㄋ一丨
苊	艹厂ㄋㄋㄋㄋ
犸	犭马ㄋㄋ一一
蘼	艹麻丨一一一
曛	日千丨ㄋ丶丿
鹾	⺊囗丿丶丶丿
隹	隹丿丨丶一一
衄	丿皿ㄋ丨一一
蛲	虫尧一ㄋ丿一
槔	木白一丿丶一
辊	车日一ㄋ丿ㄋ
泫	氵亠ㄋㄋ丶丶
墀	土尸丨丶一丿
玢	王分丿丶ㄋ丿
酐	酉干一一丨丨
瞋	目直丿丶丶丶
銎	工几丶丿丶一
噻	口寒一丨一一
猗	犭大一丨ㄋ一
嚯	口丿丨丶一
堞	土廿ㄋ一丨丿
逑	求辶丶ㄋ丶丶
硖	石夹丿丶丶丶
畀	畀丨ㄋ一丨一
尥	尢勹丶丶丶丶
嵛	山亼丨ㄋ一一
逯	水丶ㄋ丶丶
鲃	鱼巴ㄋ丨一ㄋ
溧	氵覀一丨丿丶
嫒	女一丿ㄋ丶
鄞	堇阝ㄋ丨丨丨
黧	禾勹丿丨ㄋ丶
沆	氵亠丿ㄋㄋㄋ
鹈	弟鸟丿ㄋ丶ㄋ
呖	口厂ㄋ丿丿丿
谵	讠厃丿丶丶一
缣	纟兼丶丿一ㄋ
塬	土厂丿丨ㄋ一
偬	亻勿丶丶ㄋ丶
窭	穴米ㄋ丿一一
嬲	田力ㄋ丿一ㄋ
肭	月内丨ㄋ丿丶
篯	钅一一ㄋ丿
鹱	鸟艹丿丨丶一
喱	口厂丨ㄋ一一
赀	此贝丨ㄋ丿丶
铋	钅心丿丿丿丿
曩	日亠丨ㄋ一丨
溘	氵去丨ㄋ丨丨
箪	单丶丿丨ㄋ
裣	衤亼丶丶丿一
秫	禾木丶丶丶丶
蒌	艹米ㄋ丿一一
泔	氵甘一丨丨一
酃	吅丨ㄋ一ㄋ
朊	月二丿ㄋㄋㄋ
迕	十丶ㄋ丶丶
仫	亻丿ㄋ丶丶丶
鳙	鱼广ㄋ一一丨
鬟	髟罒一丨ㄋ一
挹	扌口ㄋ丨一ㄋ
盱	目于一一丨丨
钎	钅千丿一丨丨
悱	忄非丨一一一
胙	月乍丿一丨一
捭	扌卑丿丨ㄋ一
芑	艹己ㄋ一ㄋㄋ
糇	米亻ㄋ一丿一
欹	大可丿ㄋ丿丶
瞽	壴十ㄋ丶丨ㄋ
甾	巛田丨ㄋ一丨
鹪	隹灬丿ㄋ丶ㄋ
崤	山㐅一丿丨ㄋ
澶	氵亠丨ㄋ丨ㄋ
铯	钅ㄋ丨一ㄋ
缡	纟㐫丨ㄋㄋ丶
钇	钅乙ㄋㄋㄋㄋ
鞔	革丿ㄋㄋㄋ
鲚	鱼文丿丨丨丨
玎	王丁一丨丨丨
猊	犭臼丿ㄋㄋㄋ
阊	门日丨ㄋ一一
嘬	口日一丨丨一
锜	钅大一丨ㄋ一
湔	氵前丶丿一丨
籼	米山丨ㄋ丨丨
燹	豕豕丶丿丿丶
庹	度尺ㄋ一丿丶
舾	舟西一丨ㄋ丿
渖	氵宀丨ㄋ一一
锊	钅爫一丨丶丶
祕	礻心丿丿丿丿
甯	宀心丨ㄋ一一
蓼	艹羽丿丶丿丿
瑷	王一丿ㄋ丶
钯	钅巴ㄋ丨一ㄋ
幛	巾音一丨丨丨
篦	丿丶一一
褊	衤户丨ㄋ一丨
葑	艹圭一丨丶丶
癔	疒音丶ㄋ丶丶
麇	鹿禾丿一丨丿
蚍	虫比一ㄋ丿ㄋ
浼	氵丿ㄋㄋㄋ
樘	木一丨一一
锼	钅臼丨丨丨丨
岣	山勹丨ㄋ一一
穸	穴夕丿ㄋ丶丶
敫	白方丿一丿丶
铒	钅耳一丨丨一
钫	钅方丶一ㄋ丿
钔	钅门丶丨ㄋㄋ
锿	钅丿ㄋ丿丶
嵯	山一丨一一
泮	氵半丶丿一一
瀣	氵⺊丿ㄋ丶ㄋ
戗	人一ㄋ丿丶
皴	厶八丿ㄋ丶ㄋ
轫	车刀丶丶丶丶
睃	目厶丿丶丿ㄋ
遄	山而丶ㄋ丶丶
逭	宀㠯丶ㄋ丶丶
莩	艹爫ㄋ丨一一
篁	白一一丨一
醍	酉是丨ㄋ一一
锱	钅巛丨ㄋ一丨
褰	寒衣丶一丿ㄋ
葚	艹其ㄋㄋㄋㄋ
炱	厶口丶丿丿丶
睥	目卑丿丨ㄋ一
驽	奴马ㄋㄋ一一
辚	车米丿ㄋ丶一
驺	马刍丿ㄋㄋ一
筇	工ㄋ丨丨丨
髀	骨卑丿丨ㄋ一
戥	日生一ㄋ丿丶
鸺	亻木丿ㄋ丶ㄋ
眇	目少丨丿丶丿
楮	木者一丨一丿
迓	牙辶丶ㄋ丶丶
哙	口人一一ㄋ丶
逄	夂㐄丶ㄋ丶丶
濞	氵自丨ㄋ一丨
桤	木山ㄋ一ㄋㄋ
磙	石六ㄋ丶丿ㄋ
疳	广甘一丨丨一
砜	石几丿丶丶丶
炻	火石一丿丨ㄋ
鹮	罒丿ㄋ丿丶
醭	酉业丶丿一一
鳇	鱼白一一丨一
唢	口丨ㄋ丿丶
仡	亻ㄋㄋㄋㄋ
醐	酉古丿ㄋ一一
菘	艹木丿丶丶丶
殳	殳丿ㄋㄋ丶丶
獍	犭音丿ㄋㄋㄋ
栌	木⺊ㄋ一丿丿
馇	饣木丨ㄋ一一
祢	礻尔丿ㄋ丨丿
暝	日冖丨ㄋ一一
磴	石癶一丨ㄋ一
搴	寒手丿一一丨
尕	乃小丨丿丶丶
殄	歹人丿丿丿丿
豉	豆十ㄋ丶丶丶
湓	氵分丨ㄋ丨丨
垴	土㐫丶一丿丶
薅	艹女一丿丿丿
刿	山夕丨丨丨丨
锝	钅日一一丨丶
葜	艹丰ㄋ丿一丿
艚	舟一丨ㄋ一丨
镅	钅丨ㄋ一一
黼	业㡀丿一丿丶
蹀	廿ㄋ一丨丿
蟥	虫丨ㄋ一丨
瓿	立口一ㄋㄋ丶
氙	气山丨ㄋ丨丨
铑	钅耂丿ㄋㄋㄋ
煺	火艮丶ㄋ丶丶
踟	矢丨ㄋ一一
鲷	鱼冂一丨一丨
膂	族丨ㄋ一一
杪	木少丨丿丶丿
砬	石立丶一丶丿
蒡	艹丶一ㄋ丿
酽	酉亚丿丿丿丿
蒴	艹屰丿ㄋ一一
硭	石艹丶一ㄋㄋ
肜	月彡丿丿丿丿
猡	犭罒丿ㄋ丶丶
藁	艹丨ㄋ一一
漯	氵田ㄋㄋ丶丨
皤	白釆丨ㄋ一丨
旒	族丿丨ㄋㄋ
殍	歹爫ㄋ丨一一
哏	口艮ㄋ一一ㄋ
锍	钅丿丨ㄋㄋ
鞲	革丨ㄋ一丨
硇	石丿丶一一
哿	加可一丨ㄋ一
姝	女丿丨丿丶丶
镬	钅艹丿丨丶一
茭	艹六丿丶丶丶
喹	口大一丨一一
溏	氵广ㄋ一一丨
畋	田攵丿一丿丶
鲔	鱼丨ㄋ一一
鸲	勹口丿ㄋ丶ㄋ
窆	穴丿丶ㄋ丶丶
跶	大丶ㄋ丶丶
谂	讠今丶ㄋ丶丶
髟	髟一丨一一一
橥	犭者一丨丿丶
赉	夹来丨ㄋ丿丶
骘	阝止丨丿丿ㄋ
羼	尸羊丶丿一一
缧	纟田ㄋㄋ丶丨
镓	钅宀一丿ㄋ丿
窬	穴亼丨ㄋ一一
吣	口心丶ㄋ丶丶
邳	不一ㄋ丨丨丨
溲	氵臼丨ㄋ丶丶
筌	人一一丨一
孥	奴子ㄋ丨一一
璩	王虍一丿ㄋ丿
敉	米攵丿一丿丶
鸸	而鸟丿ㄋ丶ㄋ
涠	氵囗一一ㄋ丨
苒	艹冂一丨一一
垓	土亥丶一ㄋ丿
脔	亦内丿丶丶丶
荸	艹ㄋ丨一一
艟	舟立丨ㄋ一一
甓	辟瓦一ㄋㄋ丶
锪	钅勿丶ㄋ丶丶
镄	钅弓丿丨丨ㄋ
眬	目龙一丿ㄋ丿
旄	族毛丿一一ㄋ
彘	彑匕丿一一丿
檠	芍口丿一丿丶
祆	礻夭丿一丿丶
胩	月上丨丶丶丶
啰	口罒丿ㄋ丶丶
芠	艹文丶一丿丶
柒	氵七一丨丿丶
珉	王民ㄋ一ㄋ一
镔	钅宀丿丨一丨
霈	氵一丨ㄋ丨
惇	忄ㄋ丨一一
菡	艹了丶一丿丶
棹	木⺊丨ㄋ一一
糗	米自一丿丶丶
绡	纟丨ㄋ一一
囗	囗丨ㄋ一一一
妤	女予ㄋ丶ㄋ丨
玟	王文丶一丿丶
孑	孑ㄋ丨一一一
箐	青一一丨一
嫫	女莫一丨丨丨
爿	爿ㄋ丨一丿丿
葳	艹戊一ㄋ丿一
婠	女宀丨ㄋ一ㄋ
嫚	女日丨ㄋ丨丨
螓	虫一丨丿丶
箬	艹一丿丨ㄋ
扞	扌干一一丨丨
荑	艹大ㄋ一ㄋㄋ
葶	艹一丨丨丨
姮	女一丨ㄋ一一
珅	王日丨丨丨丨
塆	亦ㄋ一ㄋㄋ
岙	夭山丨ㄋ丨丨
辂	车各丿ㄋ丶丨
珣	王勹丨ㄋ一一
猱	犭矛一丨丿丶
仝	人工一丨一一
獒	敖犬一丿丶丶
濛	氵一一丿ㄋ
潋	氵亼丶丶丿一
酡	酉宀丿ㄋㄋㄋ
茛	艹艮ㄋ一一ㄋ
瑗	王爫一一丿ㄋ
阚	门乛一丨丨一
郜	告阝ㄋ丨丨丨
蓁	艹一丨丿丶
埭	土丨丶一丿
轾	车至一ㄋ丶一
搦	扌弓丶一ㄋ一
跖	石一丿丨ㄋ
眙	目厶丨ㄋ一一
垸	土宀一一丿ㄋ
邡	方阝ㄋ丨丨丨
骢	马丿丶一丶
睚	目厂一丨一一
玥	王月丿ㄋ一一
搠	扌屰丿ㄋ一一
樨	木尸丨丶一丿
珪	王圭一丨一一
滘	氵冖丿丶一丨
戢	口耳一ㄋ丿丶
垟	羊丶丿一一
麴	十人丿ㄋ丶丿
徼	彳白丶一ㄋ丿
荦	牛丿一一丨
骝	马丨ㄋ一丨
郗	乂丨ㄋ丨ㄋ
扃	户冂丨ㄋ一一
沭	氵木丶丶丶丶
骐	马其一丨丨一
屦	尸彳丶丿一丨
矞	矛冂丿丶丨ㄋ
剡	火火丨丨丨丨
蓣	艹予一丿丨ㄋ
铙	钅尧一ㄋ丿一
骖	马丿丿丿丿
臌	月壴一丨ㄋ丶
钲	钅正一丨一丨
豸	豸丿丶丶丿ㄋ
瑄	王宀一丨ㄋ一
芘	艹比一ㄋ丿ㄋ
毵	彡丿一一ㄋ
哚	口几一丨丿丶
吲	口弓丨丨丨丨
镗	钅一丨一一
蕈	艹覀丨ㄋ一一
襦	衤一丿丨ㄋ
腈	月青一一丨一
舄	臼勹丶丶丶丶
疋	疋ㄋ丨一丿丶
訾	此言丶一一一
蓍	艹耂丿ㄋ丨ㄋ
栊	木龙一丿ㄋ丿
屣	尸彳丨一丨一
爨	冂一丨ㄋ一
脩	攵丨ㄋ一一
傕	亻冖丿丨丶一
郄	乂ㄋ丶ㄋ丨
嶷	山匕丿一一丿
埚	土口丨ㄋ丿丶
仵	亻一丨丨丨
鳐	鱼爫丿一一丨
茕	一丨丨丨
邾	丿未ㄋ丨丨丨
蘧	艹虍一丿ㄋ丿
萏	艹丿丨一ㄋ
珰	王ㄋ一一一
趱	走先丿一丨一
徂	彳且丨ㄋ一一
耋	耂匕一ㄋ丶一
塍	月一丨一一
蕤	艹豕丿一一丨
耒	耒一一一丨丿
橼	木纟ㄋㄋ一丿
柰	木示一一丨丿
檗	辟木一丨丿丶
垆	土⺊ㄋ一丿丿
菰	艹孑丿丿ㄋ丶
圉	囗土丶丿一一
麈	鹿主丶一一丨
翮	鬲羽ㄋ丶一ㄋ
彧	弋口一丿丿丿
秾	禾农丶ㄋ丿ㄋ
襞	辟衣丶一丿ㄋ
兕	凹儿丿ㄋㄋㄋ
邗	干阝ㄋ丨丨丨
帻	巾丨ㄋ丿丶
晞	日乂一丿丨ㄋ
欷	乂丨ㄋ丨丿
哓	口尧一ㄋ丿一
坼	土斤丶丶丶丶
纛	母一ㄋ一一
踬	一丨丨ㄋ
坩	土甘一丨丨一
腩	月十丨ㄋ丶丿
嬛	女罒一丨ㄋ一
慝	匚艹一丿丶ㄋ
柙	木甲丨ㄋ一一
蠃	赢虫丨ㄋ一丨
隈	阝田一ㄋ丿丶
箜	穴一丨一一
荜	艹比一丨丨丨
狺	犭言丶一一一
燠	火丶丿一丨
坻	土氏丶丶丶丶
溷	氵囗一丿ㄋ丿
篌	亻ㄋ一丿一
昝	夂卜丨ㄋ一一
嗐	口宀一一一丨
玕	王干一一丨丨
伛	亻区一丿丶ㄋ
绂	纟ㄋ丶丶丶
湜	氵是丨ㄋ一一
荇	艹彳一一丨丨
栲	木耂一ㄋㄋㄋ
眄	目正ㄋㄋㄋㄋ
暾	日ㄋ丨一丿
棻	艹分一丨丿丶
炆	火文丶一丿丶
莳	艹日一丨丶丶
侑	亻丨ㄋ一一
鳉	鱼丬丿ㄋ丶一
纮	纟ㄋ丶丶丶
镝	钅丨ㄋ一丨
瞵	目米丿ㄋ丶一
觜	此角丿ㄋ丿ㄋ
筲	丨ㄋ一一
撄	扌贝丨ㄋ丿丶
貔	豸丿丶一一
蓊	艹公ㄋ丶一ㄋ
秭	禾弟丶丿ㄋ一
翥	者者一丨一丿
蹓	丨ㄋ一丨
桷	木角丿ㄋ丿ㄋ
砑	石牙一ㄋ丨丿
陬	阝耳ㄋ丶丶丶
喆	吉吉一丨一丨
槃	舟殳一丨丿丶
垌	土冂一丨ㄋ一
坭	土尸丿ㄋㄋㄋ
雩	二ㄋㄋㄋㄋ
璟	王日丶一丨ㄋ
屌	尸口丨ㄋ丨丨
贶	贝口丿ㄋㄋㄋ
瘗	疒夹丿丶一丨
絜	丰刀ㄋㄋ丶丨
絷	执糸ㄋㄋ丶丨
罍	田田丨ㄋ一丨
珙	王共一丨丨一
琚	王尸一丨丨ㄋ
酹	酉爫一丨丶丶
飏	几乂ㄋ丿丿丿
犴	犭干一一丨丨
觚	角瓜丿丿ㄋ丶
歃	千臼丿ㄋ丿丶
尻	尸九丿ㄋㄋㄋ
酲	酉口一一丨一
鳜	鱼厂丶丿一ㄋ
蝾	虫一丨丿丶
毳	毛毛丿一一ㄋ
鲽	鱼廿ㄋ一丨丿
貅	豸亻一丨丿丶
髫	髟刀丨ㄋ一一
沔	氵正ㄋㄋㄋㄋ
鬲	鬲一丨ㄋ一丨
刳	大二ㄋ丨丨丨
黥	黑京丶一丨ㄋ
鲙	鱼人一一ㄋ丶
棰	木垂丿一丨一
禊	礻丰ㄋ丿一丿
颡	又双一丨丿丶
鲭	鱼青一一丨一
觇	占见丨ㄋ丿ㄋ
骀	马厶丨ㄋ一一
柽	木又一丨一一
颙	日⽱一丿丨ㄋ
棼	林分丿丶ㄋ丿
杌	木一丿ㄋㄋㄋ
妁	女勹丶丶丶丶
巯	轻丿丨ㄋㄋ
泺	氵丨丿丶丶
觌	十乛丶丶一丿
捽	扌亠丿丶丿丶
堠	土亻ㄋ一丿一
埒	土爫一丨丶丶
鲵	鱼臼丿ㄋㄋㄋ
幪	巾一一丿ㄋ
萜	艹巾丨一丨ㄋ
葸	艹田丶ㄋ丶丶
吖	口丷丨丨丨丨
桴	木爫ㄋ丨一一
谮	讠旡一ㄋ丿ㄋ
湲	氵爫一一丿ㄋ
跂	十ㄋ丶丶丶
茆	艹卯丿ㄋ丿ㄋ
蓐	艹辰一丨丶丶
椹	木其ㄋㄋㄋㄋ
柝	木斤丶丶丶丶
岈	山牙一ㄋ丨丿
踣	立丨ㄋ一一
蒹	艹兼丶丿一ㄋ
舁	臼廾一丿丨丨
毽	毛聿ㄋ丶丶丶
妣	女比一ㄋ丿ㄋ
禛	礻直丿丶丶丶
怍	忄乍丿一丨一
埝	土今丶ㄋ丶丶
醅	酉立丨ㄋ一一
磻	石釆丨ㄋ一丨
埕	土口一一丨一
圯	土巳ㄋ一ㄋㄋ
鲳	鱼日丨ㄋ一一
膦	月米丿ㄋ丶一
燊	火火丶丿丿丶
莨	艹丶ㄋ一一ㄋ
苾	艹心丿丿丿丿
藨	艹鹿丶丶丶丶
殂	歹且丨ㄋ一一
铖	钅戊ㄋㄋㄋㄋ
眚	生目丨ㄋ一一
硚	石夭丿丨丨丨
鲉	鱼由丨ㄋ一丨
呣	口母ㄋㄋ丶一
摽	扌覀一一丨丿
缑	纟亻ㄋ一丿一
铊	钅宀丿ㄋㄋㄋ
骎	马彐丶ㄋㄋ丶
縠	一ㄋㄋ丶丨
悛	忄厶丿丶丿ㄋ
怿	忄又一一丨丨
拶	扌巛丿ㄋ丶丶
窅	穴目丨ㄋ一一
旻	日文丶一丿丶
玠	王人丿丨丨丨
遘	冂一丨一丶
蔌	艹束丿ㄋ丿丶
辋	车冂丶丿一丶
翛	夂ㄋ丶一ㄋ
狨	犭戈一丿丿丿
绐	纟厶丨ㄋ一一
叻	口力ㄋ丿丿丿
糨	米弓丨ㄋ一丨
悫	几丶ㄋ丶丶
祧	礻儿丶一丿丶
瑱	王直丿丶丶丶
媵	月ㄋ丿一一
猁	犭禾丨丨丨丨
狴	犭比一丨一一
鸮	口丂丿ㄋ丶ㄋ
柁	木宀丿ㄋㄋㄋ
砼	石人一丨一一
祓	礻ㄋ丶丶丶
圹	土广丶一丿丿
娈	亦女ㄋ丿一一
隰	阝日ㄋㄋ丶丶
阼	阝乍丿一丨一
崄	巾亼丶丶丿一
浥	氵口ㄋ丨一ㄋ
炘	火斤丿丿一丨
犇	牛牛丿一一丨
碁	其石一丿丨ㄋ
垱	ㄋ一一一
箨	扌ㄋ丶一一
郫	卑阝ㄋ丨丨丨
茀	艹弓丿丨丨丨
轺	车刀丨ㄋ一一
侉	亻大一一ㄋㄋ
廨	广角ㄋ丿丿一
铌	钅尸丿ㄋㄋㄋ
桄	木光丨丶丿一
昃	日厂丿丶丶丶
囷	囗禾丿一丨丿
簋	艮丨ㄋ丨丨
甍	萝冖一ㄋㄋ丶
薤	艹歹丨一一一
蚺	虫冂一丨一一
纻	纟宀一一一一
椟	木十ㄋ丶丶一
岍	山开一一丿丨
揎	扌宀一丨ㄋ一
黻	业㡀一丿ㄋ丶
酤	酉古一丨丨ㄋ
貊	豸一丿丨ㄋ一
陔	阝亥丶一ㄋ丿
鹢	䒑八丨ㄋ丨丨
烝	了一丶丶丶
燋	火隹丶丶丶丶
矇	目艹一丨丨丨
瘌	疒束丨丨丨丨
衒	彳亠ㄋㄋ丶一
蜩	虫冂一丨一丨
秕	禾比一ㄋ丿ㄋ
纩	纟广丶一丿丿
摅	扌虍丶ㄋ丶丶
邴	丙人ㄋ丨丨丨
醑	酉疋丨ㄋ一一
亶	亠回丨ㄋ一一
佺	亻人一一丨一
聱	敖耳一丨丨一
俜	亻由一ㄋㄋㄋ
猞	犭亼一丨丨ㄋ
绠	纟更一丨ㄋ一
绖	纟至一ㄋ丶一
镪	钅弓丨ㄋ一一
喈	口比丿丨ㄋ一
蓥	金丿丶一一
栳	木耂丿ㄋㄋㄋ
溽	氵辰一丨丶丶
悃	忄囗一丨丿丶
堙	土覀一丨一一
赪	赤⺊丨ㄋ丿丶
褙	衤北丨ㄋ一一
鲊	鱼乍丿一丨一
瞀	矛攵丨ㄋ一一
畤	田土一丨丶丶
彿	彳弓丿丨丨丨
萁	艹其一丨丨一
戽	户⺀一丨丨丨
绁	纟廿ㄋㄋㄋㄋ
铗	钅夹丿丶丶丶
卺	了一丶丶丶
骟	马户ㄋ丶一ㄋ
滹	氵虍丿丶丿一
泚	氵此丨一丨一
醌	酉日一ㄋ丿ㄋ
愔	忄音丶一丶丿
浬	氵里丨ㄋ一一
麹	夂丿ㄋ丶丿
躔	广丨ㄋ一一
躞	火丶一一一
躐	巛丨ㄋ一ㄋ
瘰	疒田ㄋㄋ丶丨
蓂	日丶一丿丶
鞬	革聿ㄋ丶丶丶
彖	彑丿ㄋ丿丿
鹣	兼鸟丿ㄋ丶ㄋ
缵	纟先丿一丨一
槠	木讠一丨一丿
皲	冖车ㄋ丿丨ㄋ
澌	氵其丿丿一丨
漭	氵艹一丿丶丶
洎	氵自丿丨ㄋ一
豨	豕乂一丿丨ㄋ
囝	囗子ㄋ丨一一
刬	戋刂丨丨丨丨
嚭	壴口一丿丨丶
堃	方方一丨一一
籀	扌丿ㄋ丶ㄋ
籥	合丨ㄋ一丨
郇	勹隹ㄋ丨丨丨
坌	分土一丨一一
詟	龙言丶一一一
阇	门者一丨一丿
枧	木见丨ㄋ丿ㄋ
晡	日甫一丨ㄋ一
崦	山大丨ㄋ一一
裒	亠臼丿ㄋ丿丶
襻	衤木丿丶丿丶
埗	止丨丿丿丿
飐	几乂丨一丨ㄋ
瞢	萝目丨ㄋ一一
茌	荷士一丨一一
蝓	虫亼丨ㄋ一一
靺	革一一丨丿丶
扆	户衣丶一丿ㄋ
嗞	口䒑ㄋㄋ丶ㄋ
挢	扌夭丿丨丨丨
埴	土直一丨丨ㄋ
蝥	矛攵丨ㄋ一丨
脶	月口丨ㄋ丿丶
悰	忄宀一一丨丿
冇	冂丨ㄋㄋㄋ
跬	圭一丨一一
蝰	虫大一丨一一
儇	亻丿ㄋ丿丶
梃	木壬ㄋ丶丶丶
旰	日干一一丨丨
忮	忄十ㄋ丶丶丶
埏	土丿丨一丨一
埸	土日丿ㄋ丿丿
谳	讠十丨ㄋ丶丿
酎	酉寸一丨丶丶
舣	舟义丶丿丶丶
尪	尢王一一丨一
崁	山土丿ㄋ丿丶
擿	扌丨ㄋ丿丶
牤	牜亡丶一ㄋㄋ
赆	贝尺丶丶丶丶
癃	疒阝丿ㄋ丶丿
髹	髟亻一丨丿丶
钽	钅旦丨ㄋ一一
泖	氵卯丿ㄋ丿ㄋ
豳	山豕一丿ㄋ丿
祼	礻日一丨丿丶
罽	罒厂丶丿丿丶
畎	田犬一丿丶丶
酞	酉大丶丶丶丶
舡	舟工一丨一一
舳	舟由丨ㄋ一丨
崟	山金丿丶一一
抃	扌丶一丨丶丶
簏	鹿丶一丿ㄋ
亍	亍一一丨丨丨
邠	分阝ㄋ丨丨丨
丌	丌一丿丨丨丨
缊	纟日丨ㄋ丨丨
哕	口山丿ㄋ丶丶
糸	糸ㄋㄋ丶丨丿
曈	日立丨ㄋ一一
洇	氵因丨ㄋ一丿
罨	罒大丨ㄋ一一
邽	圭阝ㄋ丨丨丨
鞳	革艹丿丶一丨
亹	亠冂一丨ㄋ一
嵚	山钅丿ㄋ丿丶
涴	氵宀丿ㄋ丶ㄋ
沢	氵尺ㄋ一丿丶
璺	冂一丨ㄋ一
筚	比一丨丨丨
鞮	革是丨ㄋ一一
缌	纟田丶ㄋ丶丶
绋	纟弓丿丨丨丨
幞	巾业丶丿一一
耧	耒米ㄋ丿一一
驵	马且丨ㄋ一一
栝	木舌丿一丨丨
枘	木内丨ㄋ丿丶
旸	日㇡丿丿丿丿
岜	山巴ㄋ丨一ㄋ
鲥	鱼日一丨丶丶
洿	氵大一一ㄋㄋ
溦	氵山一丿ㄋ丿
擐	扌罒一丨ㄋ一
疔	疒丁一丨丨丨
瘆	疒丿丿丿丿
蔟	艹族丿一一丿
蓠	艹㐫丨ㄋㄋ丶
椠	车斤一丨丿丶
轹	车丨丿丶丶
豇	豆工一丨一一
锞	钅日一丨丿丶
唣	口白一ㄋㄋㄋ
檑	木丨ㄋ一丨
贳	廿乚丨ㄋ丿丶
泐	氵阝ㄋ丿丿丿
祎	礻韦一一ㄋ丨
祲	礻彐丶ㄋㄋ丶
霅	言丶一一一
亸	子丶丿丨ㄋ
卬	卩ㄋ丨丨丨
垚	土一丨一一
楯	木一丨丨ㄋ
欸	厶矢丿ㄋ丿丶
沚	氵止丨一丨一
潾	氵米丿ㄋ丶一
璘	王米丿ㄋ丶一
觏	冂一丨一丨
篚	匚丨一一一
蹁	户丨ㄋ一丨
疬	疒厂ㄋ丿丿丿
瘳	疒羽丿丶丿丿
菉	艹丨ㄋ丿丶
缳	纟丿ㄋ丿丶
唛	口丿ㄋ丶丶
耜	耒㠯丨ㄋ一ㄋ
枨	木长丿一ㄋ丶
眊	目毛丿一一ㄋ
禋	礻覀一丨一一
攮	扌丨ㄋ一丨
袪	衤去一丨一ㄋ
襕	衤门一丨ㄋ一
俶	亻上丨丿丶ㄋ
倕	亻垂丿一丨一
夐	𠔿丨ㄋ一一
惛	忄氏丨ㄋ一一
曌	日月丶丶ㄋ丿
黉	丨ㄋ一丨
赙	贝甫一丨丶丶
瘐	疒臼丿丶丶丶
苈	艹厂ㄋ丿丿丿
萆	艹卑丿丨ㄋ一
蜱	虫卑丿丨ㄋ一
桫	木氵丨丿丶丿
潲	氵禾丨丶丿丨
洫	氵丿丨ㄋ丨丨
沩	氵丶ㄋ丿丶丶
嶒	山曾丶丿丨ㄋ
惝	忄丨ㄋ丨ㄋ
埤	土卑丿丨ㄋ一
珺	王尹丨ㄋ一一
酺	酉甫一丨ㄋ一
翚	羽冖一ㄋ一丨
艨	舟一一丿ㄋ
瓘	王艹丨ㄋ一丨
皦	白白丶一ㄋ丿
乂	乂丿丶丶丶丶
羝	氏丶丶丶丶
趵	勹丶丶丶丶
蹐	丿丶丨ㄋ
跱	土一丨丶丶
瘵	疒一一丨丿
瘼	疒莫一丨丨丨
菪	艹宀一丿丨ㄋ
蕞	艹日一丨丨一
辀	车舟丿丿ㄋ丶
仉	亻几丿ㄋㄋㄋ
僇	亻羽丿丶丿丿
狳	犭亼一丨丿丶
犰	犭九丿ㄋㄋㄋ
鞨	革日丿ㄋ丿丶
黟	黑夕丿ㄋ丶丶
綮	户攵ㄋㄋ丶丨
镦	钅ㄋ丨一丿
鼯	鼠五丨ㄋ一一
鸰	令鸟丿ㄋ丶ㄋ
骍	马辛丶一丶丿
鹍	日比丿ㄋ丶ㄋ
磡	石其ㄋㄋ丿丿
忭	忄丶一丨丶丶
忉	忄刀ㄋ丿丿丿
怃	忄一一丿ㄋㄋ
擗	扌辟ㄋ一丿丨
掎	扌大一丨ㄋ一
诐	讠皮ㄋ丿丨ㄋ
鲻	鱼巛丨ㄋ一丨
鲹	鱼丿丿丿丿
龁	齿ㄋㄋㄋㄋ
盦	今酉丨ㄋ丨丨
咍	口厶丨ㄋ一一
壸	亚一丨丨丶
沄	氵云一一ㄋ丶
皞	白白一丿丶一
赑	贝贝丨ㄋ丿丶
芴	艹勿丿ㄋ丿丿
蒽	艹因丶ㄋ丶丶
蜞	虫其一丨丨一
夼	大川丿丨丨丨
仳	亻比一ㄋ丿ㄋ
狃	犭丑ㄋ丨一一
庳	广卑丿丨ㄋ一
魋	鬼隹丿丨丶一
帱	巾一丨丶丶
镘	钅日丨ㄋ丨丨
噍	口隹丶丶丶丶
呙	口内丨ㄋ丿丶
瀹	氵亼丨ㄋ一丨
屺	山已ㄋ一ㄋㄋ
碲	石丨ㄋ丨丨
掊	扌立丨ㄋ一一
垤	土至一ㄋ丶一
窊	穴瓜丿丿ㄋ丶
谫	讠前ㄋ丿丿丿
襜	衤厃丿丶丶一
酾	酉丽一丨ㄋ丶
霪	氵丿丶丶丿
鄠	二ㄋㄋ丨丨
吽	口牛丿一一丨
恓	忄西一丨ㄋ丿
浐	氵一丿丿丿
滉	氵日丨丶丿一
琇	王禾ㄋ丿丿丿
箅	畀丨ㄋ一丨
趼	开一一丿丨
蹅	木丨ㄋ一一
蒗	落丶ㄋ一一ㄋ
苘	艹冂丨ㄋ一一
薷	艹一丿丨ㄋ
蚵	虫丁丨ㄋ一一
傒	亻爫ㄋㄋ丶一
顸	干页一丿丨ㄋ
稃	禾爫ㄋ丨一一
焜	火日一ㄋ丿ㄋ
缋	纟丨ㄋ丿丶
绗	纟彳一一丨丨
镟	钅族丨一丿丶
哜	口文丿丨丨丨
阘	门日ㄋ丶一ㄋ
楗	木聿ㄋ丶丶丶
氽	人水丨ㄋ丿丶
浍	氵人一一ㄋ丶
滏	氵父一一丨丶
崚	山土丿丶丿ㄋ
撙	扌酋一丨丶丶
摛	扌㐫丨ㄋㄋ丶
颃	亠几一丿丨ㄋ
酴	酉亼一丨丿丶
貘	豸莫一丨丨丨
舯	舟中丨ㄋ一丨
馘	䒑自一ㄋ丿丶
镵	钅一ㄋ丿ㄋ
唵	口大丨ㄋ一一
抔	扌不一丿丨丶
斝	吅冖丶丶一丨
梼	木一丨丶丶
齁	自畀丿ㄋ丨ㄋ
弇	合廾一丿丨丨
瘥	疒一丨一一
瘕	疒叚ㄋ一丨一
觫	角束一丨ㄋ一
镮	钅丿ㄋ丿丶
冱	冫一ㄋㄋ一一
鹇	门木丿ㄋ丶ㄋ
糍	米䒑ㄋㄋ丶ㄋ
檫	木宀丿ㄋ丶丶
矻	石ㄋㄋㄋㄋ
尢	尢一丿ㄋㄋㄋ
鲯	鱼其一丨丨一
鳣	鱼亠丨ㄋ丨ㄋ
趑	走次丶一丿ㄋ
厖	厂尢丿丿丿丶
姱	女大一一ㄋㄋ
忺	忄欠丿ㄋ丿丶
晢	折日丨ㄋ一一
渰	氵合一丿丨丨
烜	火一丨ㄋ一一
飔	几乂丨ㄋ一丨
裛	亠口ㄋ丨一ㄋ
龠	亼吅丨ㄋ一丨
筅	先丿一丨一
箦	丨ㄋ丿丶
茇	艹ㄋ丶丶丶
颟	艹丙丿丶丿丶
蜾	虫日一丨丿丶
佾	亻八丨ㄋ一一
恧	而心丶ㄋ丶丶
铪	钅合丿丶一丨
虓	九虍丿ㄋㄋㄋ
糌	米夂丨丶丨ㄋ
眭	目圭一丨一一
汆	入水丨ㄋ丿丶
漶	氵口丨ㄋ一丨
剀	山己丨丨丨丨
嵎	山日丨ㄋ丨一
饹	饣各丿ㄋ丶丨
砟	石乍丿一丨一
揸	扌木丨ㄋ一一
坜	土厂ㄋ丿丿丿
鲿	鱼丶ㄋ一一
腠	月丿一丿丶
婞	女土丶丿一一
昇	日丿一丿丨丨
枲	厶口一丨丿丶
椓	木豕丶丶丶丶
毐	士毋ㄋㄋ丿一
甪	丿用丿ㄋ一一
踦	大一丨ㄋ一
赇	贝求一丨丶一
瘅	疒单丶丿丨ㄋ
蒨	荷青一一丨一
恝	丰刀丶ㄋ丶丶
魆	鬼戉一ㄋㄋ丿
烀	火乎丿丶丿一
孓	了丶丶丶丶丶
牾	牜五丨ㄋ一一
刭	轻刂丨丨丨丨
潏	氵矛丨ㄋ丿丶
瀼	氵亠丨ㄋ一丨
硙	石山ㄋ一ㄋㄋ
圬	土二ㄋㄋㄋㄋ
璠	王釆丨ㄋ一丨
嚚	吅臣丨ㄋ一丨
裈	衤冖一ㄋ一丨
劓	自畀丨丨丨丨
逴	⺊日一丨丶ㄋ
冏	冂八丨ㄋ一一
渟	氵一丨丨丨
畬	亼朩丨ㄋ一丨
郤	八人丨ㄋ一ㄋ
菝	艹扌一丿丿丿
廒	广敖一一丨一
鹖	日勹丿丶ㄋ丿
戋	戋一一ㄋ丿丶
缲	纟口丨ㄋ一丨
锔	钅尸ㄋ丨ㄋ一
铈	钅亠丨ㄋ丨丨
骒	马日一丨丿丶
柃	木令丿丶丶ㄋ
眵	目夕丿ㄋ丶丶
洧	氵丨ㄋ一一
碶	石丰ㄋ丿一丿
矧	矢弓丨丨丨丨
榖	禾丿ㄋㄋ丶
禘	礻丨ㄋ丨丨
揲	扌廿ㄋ一丨丿
拃	扌乍丿一丨一
墁	土日丨ㄋ丨丨
璁	王丿ㄋ丶一
鲦	鱼夂一丨丿丶
鳀	鱼是丨ㄋ一一
鲬	鱼甬ㄋ丶丨ㄋ
舲	舟令丿丶丶ㄋ
隩	阝丶丿一丨
昉	日方丶一ㄋ丿
柈	木半丶丿一一
椀	木宀丿ㄋ丶ㄋ
牂	爿羊丶丿一一
郿	目ㄋ丨丨丨
勍	京力ㄋ丿丿丿
坰	冂丨ㄋ一一
酂	先先丨ㄋ丿丶
跽	己丶ㄋ丶丶
痖	疒亚一丨丨丶
癀	疒丨ㄋ一丨
茈	艹此丨一丨一
蔸	艹白丿丨ㄋ一
蝤	虫酋丶丿一丨
殪	歹一丨ㄋ一
觋	工从丨ㄋ丿ㄋ
骺	骨一丨ㄋ一
缞	纟一丿ㄋ丿
绹	纟勹丿一一丨
钐	钅彡丿丿丿丿
铫	钅儿丶一丿丶
锳	钅艹丨ㄋ一丿
唼	口立ㄋ丿一一
啫	口者一丨一丿
驲	马日丨ㄋ一一
糈	米疋丨ㄋ一一
檎	木人丶一丿丶
桕	木臼丿丨一ㄋ
嫪	女羽丿丶丿丿
郐	人云ㄋ丨丨丨
汔	氵ㄋㄋㄋㄋ
滃	氵公ㄋ丶一ㄋ
岽	山丨丿丶丶
饸	饣合丿丶一丨
礅	石ㄋ丨一丿
翾	罒丿ㄋ丿丶
揠	扌匚丨ㄋ一一
坫	土占丨一丨ㄋ
塄	土罒丶一ㄋ丿
玦	王丿丶丶丶
觱	戊丿ㄋ丿ㄋ
诇	讠冂丨ㄋ一一
鲼	鱼十一丨丨丨
毹	亼⺝丨丨丿一
臑	月一丿丨ㄋ
縢	月ㄋㄋ丶丨
艋	舟子丨ㄋ丨丨
陴	阝卑丿丨ㄋ一
劄	合丨丨丨丨
尨	尢彡丶丶丶丶
岨	山且丨ㄋ一一
崿	山吅一一ㄋㄋ
巉	山一ㄋ丿ㄋ
帨	巾𠮦丿ㄋㄋㄋ
槚	木覀丨ㄋ丿丶
氿	氵九丿ㄋㄋㄋ
熛	火覀一一丨丿
枒	木牙一ㄋ丨丿
耑	山而一丿丨ㄋ
醾	酉麻丶丿一丨
巇	山虍一丨ㄋ一
鹡	人丨ㄋ一一
埆	角丿ㄋ丿ㄋ
筦	宀一一丿ㄋ
簃	禾丿ㄋ丶丿
躜	先丿一丨一
蒻	艹弓丶一丶一
轵	车口丿丶丶丶
衎	彳干一一丨丨
螗	虫广ㄋ一一丨
蛸	虫丨ㄋ一一
僬	亻隹丶丶丶丶
俵	亻丿ㄋ丿丶
靸	革及丿ㄋ丶丶
熇	火丨ㄋ一一
钖	钅㇡丿丿丿丿
麑	鹿臼丿ㄋㄋㄋ
訚	门言丶一一一
楙	木矛一丨丿丶
氍	目目丿丨丶一
媞	女是丨ㄋ一一
鸧	人丿ㄋ丶ㄋ
渫	氵廿ㄋ一丨丿
淠	氵畀丨ㄋ一丨
嵫	山䒑ㄋㄋ丶ㄋ
崒	山亠丿丶丿丶
硁	石轻ㄋ丶一丨
谞	讠疋丨ㄋ一一
悝	忄里丨ㄋ一一
埘	土日一丨丶丶
垧	土丨ㄋ一一
瑨	王亚丨ㄋ一一
鲐	鱼厶丨ㄋ一一
脬	月爫ㄋ丨一一
舴	舟乍丿一丨一
哢	口王一丿丨丨
夬	人丿丶丶丶
峣	山尧一ㄋ丿一
廋	广臼丨ㄋ丶丶
惙	忄双ㄋ丶ㄋ丶
挦	扌彐一丨丶丶
杻	木丑ㄋ丨一一
棐	非木一丨丿丶
欻	火火丿ㄋ丿丶
氾	氵ㄋㄋㄋㄋ
浡	氵十丶ㄋㄋ丨
爇	艹土丿丶一丨
皛	白白丿丨ㄋ一
嬅	女艹一一丨丨
憝	孑丿一丿丶
翃	厶ㄋ丶一ㄋ
簕	革ㄋ丿丿丿
癍	疒王丶一丿丶
蒉	艹丨ㄋ丿丶
蔀	艹立丨ㄋ一ㄋ
萩	艹禾丶丿丿丶
荄	艹亥丶一ㄋ丿
糵	艹丿丨ㄋ一ㄋ
鬘	髟日丨ㄋ丨丨
蜎	虫口丨ㄋ一一
髎	骨羽丿丶丿丿
稂	禾丶ㄋ一一ㄋ
穟	禾丷一丿ㄋ丿
飑	几乂丿ㄋㄋ一
镙	钅田ㄋㄋ丶丨
镡	钅覀丨ㄋ一一
钬	钅火丶丿丿丶
铼	钅夹丨丿丶丶
鄜	鹿阝ㄋ丨丨丨
橦	木立丨ㄋ一一
瞍	目臼丨ㄋ丶丶
溱	氵一丨丿丶
沨	氵几丿丶丶丶
濩	氵艹丿丨丶一
屼	山一丿ㄋㄋㄋ
甏	壴彡一ㄋㄋ丶
捃	扌尹丨ㄋ一一
搒	扌丶一ㄋ丿
垲	土山ㄋ一ㄋㄋ
珧	王儿丶一丿丶
黹	业㡀丶丿丨ㄋ
醨	酉㐫丨ㄋㄋ丶
脒	月米丶丿一丨
迮	乍辶丶ㄋ丶丶
馌	饣去丨ㄋ丨丨
掞	扌火丶丿丿丶
昺	日丙丿丶丶丶
杙	木弋一ㄋ丶丶
棓	木立丨ㄋ一一
棨	户攵一丨丿丶
洑	氵亻一丿丶丶
洸	氵光丨丶丿一
淏	氵日一一丿丶
畯	田厶丿丶丿ㄋ
飗	几乂丿ㄋ丶ㄋ
篥	覀一丨丿丶
簠	甫丨ㄋ丨丨
跐	此丨一丨一
鹋	艹田丿ㄋ丶ㄋ
蔹	艹亼丶丶丿一
莰	艹土丿ㄋ丿丶
莛	艹壬ㄋ丶丶丶
荬	艹乛丶丶一丿
蒐	艹鬼丿丨ㄋ一
芃	艹几丶丶丶丶
藟	艹田丨ㄋ一丨
髽	髟从一丨一一
剞	大可丨丨丨丨
奓	大夕丿ㄋ丶丶
佧	亻上丨丶丶丶
伈	亻心丶ㄋ丶丶
狁	犭厶丿ㄋㄋㄋ
靿	革幺ㄋ丿丿丿
秬	禾匚ㄋ一一一
黪	黑丿丿丿丿
缍	纟垂丿一丨一
锇	钅我丿一丨一
铏	钅开一一丿丨
锽	钅白一一丨一
粿	米日一丨丿丶
睎	目乂一丿丨ㄋ
嫜	女音一丨丨丨
浈	氵⺊丨ㄋ丿丶
滆	氵鬲一丨ㄋ一
澥	氵角ㄋ丿丿一
碥	石户丨ㄋ一丨
謦	士丿ㄋㄋ丶
芈	丨一丨一一一
赟	文一一ㄋ丶丨
眢	夕丨ㄋ一一
尜	小大丨丿丶丶
襚	衤丷一丿ㄋ丿
鳓	鱼革ㄋ丿丿丿
鲣	鱼一丨一一
鳑	鱼丶一ㄋ丿
鲏	鱼皮ㄋ丿丨ㄋ
鲗	鱼贝丨丨丨丨
翀	羽中丨ㄋ一丨
脞	月从一丨一一
腧	月亼丨ㄋ一一
阽	阝占丨一丨ㄋ
腯	月一丨丨ㄋ
镋	钅丿ㄋㄋㄋ
剟	双双丨丨丨丨
墐	堇一丨丨一
弢	弓山ㄋ丶丶丶
暵	日廿丨ㄋ一丿
枹	木勹ㄋ一ㄋㄋ
溞	氵又丶丨ㄋ一
滪	氵予一丿丨ㄋ
潟	氵臼丿ㄋ丶丶
烺	火丶ㄋ一一ㄋ
瑑	王彑丿ㄋ丿丿
瑳	王一丨一一
踶	是丨ㄋ一一
赒	贝冂一丨一丨
赗	贝日丨ㄋ一一
瘃	疒豕丶丶丶丶
茚	艹一ㄋ丨丨
蒎	落丿ㄋ丿丶
蕰	落日丨ㄋ丨丨
辌	车京丶一丨ㄋ
墼	車凵丿ㄋㄋ丶
蝻	虫十丨ㄋ丶丿
蠋	虫罒丿ㄋ丨ㄋ
聍	耳宀一丨丨丨
耵	耳丁一丨丨丨
猰	犭丰ㄋ丿一丿
鞡	革扌丶一丶丿
瓞	瓜丿一一丿丶
廑	广堇一丨丨一
爝	火爫丨ㄋ丨丨
爚	火合丨ㄋ一丨
铷	钅女丨ㄋ一一
锾	钅爫一一丿ㄋ
镴	钅巛丨ㄋ一ㄋ
镈	钅甫一丨丶丶
鼷	鼠爫ㄋㄋ丶一
粞	米西一丨ㄋ丿
椐	木尸一丨丨ㄋ
橑	木大丶丿丨ㄋ
鹔	肀丿丨丿ㄋ
嫽	女大丶丿丨ㄋ
碹	石宀一丨ㄋ一
礌	石丨ㄋ一丨
怊	忄刀丨ㄋ一一
忳	忄屯一ㄋ丨ㄋ
憺	忄厃丿丶丶一
琭	王丨ㄋ丿丶
瑢	王穴丿丶丨ㄋ
璆	王羽丿丶丿丿
圊	囗青一一丨一
袆	衤韦一一ㄋ丨
褕	衤亼丨ㄋ一一
鹴	相丿ㄋ丶ㄋ
螣	月丨ㄋ一丨
肸	月八一丨丨丨
谿	爫幺一丿丶丿
龂	齿斤ㄋ丨丿丿
舠	舟刀ㄋ丿丿丿
蒱	艹扌一丨ㄋ一
偲	亻田丶ㄋ丶丶
儳	亻一ㄋ丿ㄋ
叆	云一丿ㄋ丶
孅	女从一ㄋ丿丶
惔	忄火丶丿丿丶
朳	木八丿丶丶丶
烔	火冂一丨ㄋ一
狝	犭尔丿ㄋ丨丿
琤	王争丿ㄋㄋ一
琯	王宀丨ㄋ一ㄋ
疢	疒火丶丿丿丶
彳	彳丿丿丨丨丨
澴	氵罒一丨ㄋ一
埼	大一丨ㄋ一
墦	釆丨ㄋ一丨
篼	白丿ㄋ丿ㄋ
簰	片丿丨ㄋ一
筥	口丨ㄋ一一
羕	丶ㄋㄋ丿丶
鲞	鱼丿ㄋ丨ㄋ
蹯	釆丨ㄋ一丨
冁	单尸一丨丨一
雊	勹口丿丨丶一
蕺	艹口一丨丨一
茺	艹丿ㄋㄋㄋ
莶	艹亼丶丶丿一
茝	艹一丨丨ㄋ
鬏	髟禾丶丿丿丶
劂	厂屰丿ㄋ丿丶
黡	厂犬丨ㄋ丶丿
辁	车人一一丨一
螋	虫臼丨ㄋ丶丶
仂	亻力ㄋ丿丿丿
伋	亻及丿ㄋ丶丶
稆	禾口丨ㄋ一一
纴	纟壬丿一丨一
觖	角丿丶丶丶
觿	角山丿丨丶一
铘	钅牙ㄋ丨丨丨
铟	钅因丨ㄋ一丿
锓	钅彐丶ㄋㄋ丶
镠	钅羽丿丶丿丿
唪	口一一丨丨
耇	耂勹丨ㄋ一一
杩	木马ㄋㄋ一一
胬	奴内丿丶丶丶
昽	日龙一丿ㄋ丿
滠	氵耳ㄋ丶ㄋ丶
瀵	氵米丨ㄋ一丨
岠	山匚ㄋ一一一
疐	田ㄋ丨一丿
矰	矢曾丶丿丨ㄋ
祃	礻马ㄋㄋ一一
韨	韦ㄋ丶丶丶
彟	彐寸一丨丨ㄋ
酏	酉也ㄋ丨ㄋㄋ
鲕	鱼而一丿丨ㄋ
鳂	鱼田一ㄋ丿丶
颥	而一丿丨ㄋ
胲	月亥丶一ㄋ丿
腘	月囗一一丨一
胠	月去一丨一ㄋ
艎	舟白一一丨一
隃	阝亼丨ㄋ一一
耰	耒丆丨ㄋ一一
簉	告丶ㄋ丶丶
糒	米丿丿ㄋ一
讻	讠乂ㄋ丨丨丨
蓢	艹丶ㄋ一一ㄋ
叇	云丨丶一丿
嘚	口彳丨ㄋ一一
噀	口巳ㄋ一ㄋ一
坬	瓜丿丿ㄋ丶
埵	垂丿一丨一
慆	忄爫丿丨一ㄋ
棬	木ㄋㄋㄋㄋ
椑	木卑丿丨ㄋ一
殣	歹堇一丨丨一
涘	氵厶丿一一丿
湉	氵忄丿一丨丨
玃	犭目丨ㄋ一一
甦	更生丿一一丨
邶	北阝ㄋ丨丨丨
郈	ㄋ丨丨丨
簖	米ㄋ丿丿一
筻	更一丨ㄋ一
蹜	宀丿丶一丿
赕	贝火丶丿丿丶
蓰	艹彳丨一丨一
茳	落工一丨一一
茼	艹冂一丨ㄋ一
蔊	艹火丨ㄋ一一
辒	车日丨ㄋ丨丨
衠	彳直丿丶一一
蟫	虫覀丨ㄋ一一
鄹	耳又丿丨丿丿
廾	廾一丿丨丨丨
鹙	禾火丿ㄋ丶ㄋ
燏	火矛丨ㄋ丿丶
缏	纟亻一丨ㄋ一
绤	纟八丿丶丨ㄋ
铚	钅至一ㄋ丶一
哳	口折一丨一丿
喤	口白一一丨一
慭	夹来一丿丶丶
惎	其心丶ㄋ丶丶
澉	氵乛一丨丨一
沲	氵ㄋ丨ㄋㄋ
馉	饣骨丨ㄋㄋ丶
饳	饣屮ㄋ丨丨丨
攉	扌丿丨丶一
坶	土母ㄋㄋ丶一
珌	王心丿丿丿丿
鹯	亠回丨ㄋ一一
敔	五口丿一丿丶
鲴	鱼囗一丨丨ㄋ
鲌	鱼白丿丨ㄋ一
遹	矛冂丿丶丨ㄋ
臜	月先丿一丨一
朏	月屮ㄋ丨丨丨
舭	舟比一ㄋ丿ㄋ
趯	走羽丿丨丶一
陧	阝日一丨一一
陞	阝丿一丿丨一
佽	亻次丶一丿ㄋ
偓	亻尸一ㄋ丶一
偭	亻面一丿丨ㄋ
僰	朿朿丿丶丶丶
垞	宀丿一ㄋㄋ
塅	段丿丨一一
嬿	女廿丨ㄋ一丶
帡	巾䒑一丿丨丨
悢	忄丶ㄋ一一ㄋ
捯	扌至丨丨丨丨
斠	冂一丨一丶
旐	方丿ㄋ丶一
昒	日勿丿ㄋ丿丿
晫	日⺊丨ㄋ一一
柷	木口丿ㄋㄋㄋ
棁	木𠮦丿ㄋㄋㄋ
洺	氵夕丨ㄋ一一
淜	氵月丿ㄋ一一
滫	氵丿一丿丶
澛	氵鱼丨ㄋ一一
焞	火ㄋ丨一一
璈	王敖一一丨一
堨	日丿ㄋ丿丶
虒	虍丿ㄋㄋㄋ
鳘	母丿一丿丶
羖	殳丿ㄋㄋ丶
踺	聿ㄋ丶丶丶
鄫	曾阝ㄋ丨丨丨
鹎	卑鸟丿ㄋ丶ㄋ
痦	疒五丨ㄋ一一
蕻	艹镸一丨丨一
菂	艹白丿ㄋ丶丶
蒟	艹立丿ㄋ丨ㄋ
芼	艹毛丿一一ㄋ
鬒	髟直丿丶丶丶
蝘	虫匚丨ㄋ一一
倞	亻京丶一丨ㄋ
偰	亻丰ㄋ丿一丿
繄	匚矢丿ㄋㄋ丶
稌	禾亼一丨丿丶
扊	户火丶丿丿丶
煴	火日丨ㄋ丨丨
铞	钅口丨ㄋ丨丨
钆	钅乚ㄋㄋㄋㄋ
镃	钅䒑ㄋㄋ丶ㄋ
锧	钅一丨丿丶
鼢	鼠分丿丶ㄋ丿
咇	口心丿丿丿丿
耔	耒子ㄋ丨一一
榍	木尸丨丶丿丨
眍	目区一丿丶ㄋ
牿	牜告丿一丨一
姤	女一丨ㄋ一
昈	日户丶ㄋ一丿
洚	氵夂一ㄋ丨丨
滗	氵丿一一ㄋ
薢	氵角ㄋ丿丿一
湑	氵疋丨ㄋ一一
翙	山夕ㄋ丶一ㄋ
岞	山乍丿一丨一
屃	尸贝丨ㄋ丿丶
磉	石又ㄋ丶ㄋ丶
砘	石屯一ㄋ丨ㄋ
祏	礻石一丿丨ㄋ
禔	礻日丨ㄋ一一
掭	扌天丨丶丶丶
搛	扌兼丶丿一ㄋ
堍	土丿ㄋ丶丶
玚	王㇡丿丿丿丿
迺	西辶丶ㄋ丶丶
邲	心丿ㄋ丨丨丨
窎	穴鸟丿ㄋ丶ㄋ
讱	讠刀丶丶丶丶
鲩	鱼宀一一丿ㄋ
鲒	鱼吉一丨一丨
鳠	鱼艹丿丨丶一
腽	月日丨ㄋ丨丨
膣	月穴一ㄋ丶一
脿	月丿ㄋ丿丶
疍	疋旦丨ㄋ一一
鼽	自畀丿ㄋㄋㄋ
蹢	丨ㄋ一丨
鞁	革皮ㄋ丿丨ㄋ
倓	亻火丶丿丿丶
冮	冫工一丨一一
勚	廿乚丨ㄋ丿丶
奡	丆目一丿丶丿
奭	大一丿丨ㄋ一
姞	女吉一丨一丨
娀	女戈一丿丿丿
娵	女耳ㄋ丶丶丶
婘	女ㄋㄋㄋㄋ
媭	彡页ㄋ丿一一
嫄	女厂丿丨ㄋ一
嫕	女匚丿一一丿
孖	子子ㄋ丨一一
庼	广一丿丨ㄋ
忞	文心丶ㄋ丶丶
晙	日厶丿丶丿ㄋ
柊	木夂丶丶丶丶
梿	木车丶ㄋ丶丶
棫	木戈丨ㄋ一一
槱	木酉丶丶丶丶
汋	氵勹丶丶丶丶
浉	氵一丨ㄋ丨
瀍	氵广丨ㄋ一一
焗	火尸ㄋ丨ㄋ一
犨	隹隹丿一一丨
玘	王己ㄋ一ㄋㄋ
玡	王牙一ㄋ丨丿
琫	王一一丨丨
琲	王非丨一一一
璪	王口丨ㄋ一丨
皭	白爫丨ㄋ丨丨
傢	亻宀一丿ㄋ丿
薿	艹匕丿一一丿
鹛	目丿ㄋ丶ㄋ
鄗	口ㄋ丨丨丨
悆	亼朩丶ㄋ丶丶
埇	甬ㄋ丶丨ㄋ
筢	扌ㄋ丨一ㄋ
箢	宀丿ㄋ丶ㄋ
筀	圭一丨一一
羑	久丿ㄋ丶丶
桊	木一丨丿丶
踒	禾ㄋ丿一一
瘊	疒亻ㄋ一丿一
疰	疒主丶一一丨
菥	艹木丿丿一丨
蒇	艹戊丨ㄋ丿丶
蕹	艹亠ㄋㄋ丿丿
苠	艹民ㄋ一ㄋ一
蕗	艹丿ㄋ丶丨
藠	艹白丿丨ㄋ一
蘘	艹亠丨ㄋ一丨
萚	艹扌ㄋ丶一一
髢	髟也ㄋ丨ㄋㄋ
鸻	彳亍丿ㄋ丶ㄋ
傺	亻一一丨丿
佴	亻耳一丨丨一
儦	亻鹿丶丶丶丶
猃	犭亼丶丶丿一
猇	犭虍丿ㄋㄋㄋ
匼	匚合丿丶一丨
靰	革一丿ㄋㄋㄋ
鹀	工从丿ㄋ丶ㄋ
艴	弓丿ㄋㄋ丨
鹒	广彐丿丶丿ㄋ
稑	禾土丿丶一丨
稙	禾直一丨丨ㄋ
甗	虍鬲一ㄋㄋ丶
扅	户夕丿ㄋ丶丶
觭	角大一丨ㄋ一
锎	钅门一一丿丨
镩	钅宀丿丶丶丶
镲	钅宀丿ㄋ丶丶
镱	钅音丶ㄋ丶丶
镨	钅䒑丨丨丶丿
锬	钅火丶丿丿丶
镚	钅山丿ㄋ一一
嚄	口艹丿丨丶一
耥	耒丨ㄋ丨ㄋ
耩	耒丨ㄋ一丨
麀	鹿匕丿ㄋㄋㄋ
骃	马因丨ㄋ一丿
骕	马肀丿丨丿丶
氇	毛鱼丨ㄋ一一
氆	毛䒑丨丨丶丿
梠	木口丨ㄋ一一
棽	林今丿丶丶ㄋ
榑	木甫一丨丶丶
戤	乃又丨ㄋ丨丨
砮	奴石一丿丨ㄋ
弆	去廾一丿丨丨
昫	日勹丨ㄋ一一
溻	氵日ㄋ丶一ㄋ
汧	氵开一一丿丨
漻	氵羽丿丶丿丿
嶓	山釆丨ㄋ一丨
礓	石一丨ㄋ一丨
礤	石艹丿ㄋ丶丶
碃	石青一一丨一
磹	石覀丨ㄋ一一
碨	石田一ㄋ丿丶
憭	忄大丶丿丨ㄋ
搌	扌尸一丨丨一
揞	扌立丨ㄋ一一
鬷	鬲㐅ㄋ丨ㄋ丶
埯	土大丨ㄋ一一
玼	王此丨一丨一
圌	囗山一丿丨ㄋ
袗	衤人丿丿丿丿
酦	酉发ㄋ丿ㄋ丶
鳈	鱼白丨ㄋ丿丶
鳒	鱼兼丶丿一ㄋ
鲾	鱼丨ㄋ一丨
腙	月宀一一丨丿
腒	月尸一丨丨ㄋ
盉	禾皿丨ㄋ丨丨
鲖	鱼冂一丨ㄋ一
祊	礻方丶一ㄋ丿
矼	石工一丨一一
纼	纟弓丨丨丨丨
菼	艹火丶丿丿丶
筤	丶ㄋ一一ㄋ
耏	而彡丿丿丿丿
鸤	尸鸟丿ㄋ丶ㄋ
竫	立争丿ㄋㄋ一
蟏	虫艹ㄋ一一丨
萹	艹户丨ㄋ一丨
蝲	虫束丨丨丨丨
侁	亻先丿一丨一
侂	亻广丿一ㄋㄋ
侘	亻宀丿一ㄋㄋ
偁	亻爫丨ㄋ一丨
傉	亻辰一丨丶丶
劼	吉力ㄋ丿丿丿
勔	面力ㄋ丿丿丿
匜	匚也ㄋ丨ㄋㄋ
哱	口十丶ㄋㄋ丨
啴	口单丶丿丨ㄋ
噂	口酋一丨丶丶
堉	丨ㄋ一一
堲	卩一丨一一
妧	女元一一丿ㄋ
婌	女上丨丿丶ㄋ
婼	女艹一丿丨ㄋ
宬	宀戊ㄋㄋㄋㄋ
峘	山一丨ㄋ一一
崀	山丶ㄋ一一ㄋ
嵁	山其ㄋㄋㄋㄋ
嶲	山隹丨ㄋ丨丨
弸	弓月丿ㄋ一一
摴	扌一一ㄋㄋ
昳	日丿一一丿丶
朓	月儿丶一丿丶
杕	木大一丿丶丶
桯	木口一一丨一
桹	木丶ㄋ一一ㄋ
楩	木亻一丨ㄋ一
榰	木耂丿ㄋ丨ㄋ
泙	氵平一丶丿一
泜	氵氏丶丶丶丶
湴	氵䒑丨丨丶丿
漦	未攵一丿丨ㄋ
漼	氵山丿丨丶一
澼	氵辟ㄋ一丿丨
焌	火厶丿丶丿ㄋ
爟	火艹丨ㄋ一丨
牁	爿可一丨ㄋ一
狉	犭不一一一一
猺	犭爫丿一一丨
獴	犭一一丿ㄋ
珽	王丿丨一丨一
瑀	王丿丨ㄋ一丨
甡	生生丿一一丨
骉	马马ㄋㄋ一一
囧	口八丨ㄋㄋㄋ
檵	木幺ㄋㄋ丶一
鹠	田丿ㄋ丶ㄋ
塝	丶一ㄋ丿
墈	其ㄋㄋ丿丿
垕	一丨一一
黇	由丿丶丨一
筘	扌丨ㄋ一一
鹟	公羽丿ㄋ丶ㄋ
谼	八人丨ㄋ一一
瘭	疒覀一一丨丿
葙	艹相一丨丿丶
葰	荷厶丿丶丿ㄋ
蓇	艹骨丨ㄋㄋ丶
蓏	艹瓜丿丿ㄋ丶
薳	艹吉丿ㄋ丿丶
荖	艹耂丿ㄋㄋㄋ
藦	艹麻丿一一丨
葖	艹穴一丿丶丶
莙	艹尹丨ㄋ一一
薁	艹丶丿一丨
轪	车大一丿丶丶
螵	虫覀一一丨丿
螠	虫䒑丿丶丨ㄋ
蚄	虫方丶一ㄋ丿
虸	虫子ㄋ丨一一
伭	亻亠ㄋㄋ丶丶
佖	亻心丿丿丿丿
俙	亻乂一丿丨ㄋ
儴	亻亠丨ㄋ一丨
攽	分攵丿一丿丶
穜	禾立丨ㄋ一一
穄	禾一一丨丿
觟	角圭一丨一一
钶	钅丁丨ㄋ一一
铴	钅氵ㄋ丿丿丿
镥	钅鱼丨ㄋ一一
锘	钅艹一丿丨ㄋ
锫	钅立丨ㄋ一一
镤	钅业丶丿一一
铕	钅丨ㄋ一一
钘	钅开一一丿丨
铻	钅五丨ㄋ一一
鼫	鼠石一丿丨ㄋ
咥	口至一ㄋ丶一
嘡	口一丨一一
耱	耒麻一丿丨ㄋ
耤	耒龷丨ㄋ一一
骣	马尸ㄋ丨一ㄋ
骙	马癶一一丿丶
榀	木口丨ㄋ一丨
楱	木一一丿丶
睄	目丨ㄋ一一
犋	牜丿丶丶丶
姽	女厃ㄋㄋㄋㄋ
嬥	女羽丿丨丶一
嬬	女一丿丨ㄋ
隺	冖隹丿丨丶一
凵	凵ㄋ丨丨丨丨
颋	壬廴一丿丨ㄋ
旴	日于一一丨丨
晐	日亥丶一ㄋ丿
峗	山厃ㄋㄋㄋㄋ
峿	山五丨ㄋ一一
螱	尸示一丨丶丨
磲	石氵一ㄋㄋ一
礞	石一一丿ㄋ
磜	石一一丨丿
硊	石厃ㄋㄋㄋㄋ
砫	石主丶一一丨
碏	石龷丨ㄋ一一
磏	石兼丶丿一ㄋ
搋	扌丨一ㄋ丿
扺	扌氏丿ㄋ一ㄋ
墚	土氵ㄋ丿一丨
塥	土鬲一丨ㄋ一
玱	王人ㄋㄋㄋㄋ
珷	王一一ㄋ丶丨
琄	王口丨ㄋ一一
璲	王丷一丿ㄋ丿
郪	一肀ㄋ丿一ㄋ
袯	衤发ㄋ丿ㄋ丶
瓻	乂丨ㄋ丨一
鳋	鱼又丶丨ㄋ一
鳁	鱼日丨ㄋ丨丨
鲪	鱼尹丨ㄋ一一
鳛	鱼羽丿丨ㄋ一
鱽	鱼刀ㄋ丿丿丿
翂	羽分丿丶ㄋ丿
艅	舟亼一丨丿丶
劁	隹灬丨丨丨丨
齄	自畀一丨丿丶
阢	阝一丿ㄋㄋㄋ
襫	衤大一丿丨ㄋ
鄅	丿口丨ㄋ丨一
芣	艹不一丿丨丶
靽	革半丶丿一一
骦	马一丨丿丶
靬	革干一一丨丨
荓	艹䒑一丿丨丨
硿	石穴一丨一一
笯	女ㄋ丶丶丶
衃	扌丿丨ㄋ丨丨
褟	衤日ㄋ丶一ㄋ
砆	石夫一一丿丶
硍	石艮ㄋ一一ㄋ
蔈	艹覀一一丨丿
礵	石一丨丿丶
齇	自畀丨一ㄋ丿
丏	正ㄋㄋㄋㄋ
伾	亻不一一一一
俍	亻丶ㄋ一一ㄋ
倧	亻宀一一丨丿
倴	亻大一丨一丿
僎	亻巳ㄋ一ㄋ一
冔	日口一一丨丨
凓	冫覀一丨丿丶
剕	非刂丨丨丨丨
叚	叚ㄋ一丨一一
咡	口耳一丨丨一
咺	口一丨ㄋ一一
垍	自丿丨ㄋ一
婳	女一丨ㄋ一丨
媄	女一丿丶丶
媆	女而一丿丶丶
媱	女爫丿一一丨
嫭	女虍丿丶丿一
岊	巴山丨ㄋ丨丨
峃	山丨ㄋ丨丨
峧	山六丿丶丶丶
嵲	山自一丨丿丶
幖	巾覀一一丨丿
憙	壴口丶ㄋ丶丶
拤	扌上丨丶丶丶
摏	扌丿丨一ㄋ
敩	子丿一丿丶
栟	木䒑一丿丨丨
栻	木弋一丨一一
桲	木十丶ㄋㄋ丨
梴	木丿丨一丨一
梽	木士丶ㄋ丶丶
椸	木族ㄋ丨ㄋㄋ
欂	木落一丨ㄋ一
汭	氵内丨ㄋ丿丶
沺	氵田丨ㄋ一丨
洴	氵䒑一丿丨丨
浕	氵尺丶丶丶丶
浰	氵禾丨丨丨丨
淟	氵曲丿丶丶丶
淴	氵勿丶ㄋ丶丶
澂	氵山一丿一丿
炟	火旦丨ㄋ一一
烻	火丿丨一丨一
煟	火田丨ㄋ一一
牚	牙一ㄋ丨丿
玙	王与一一一一
玞	王夫一一丿丶
玭	王比一ㄋ丿ㄋ
珝	王羽ㄋ丶一ㄋ
珫	王丿ㄋㄋㄋ
瓖	王亠丨ㄋ一丨
蛃	虫丙丿丶丶丶
揾	扌日丨ㄋ丨丨
俬	亻禾ㄋ丶丶丶
攴	⺊又ㄋ丶丶丶
遆	巾丶ㄋ丶丶
坋	分丿丶ㄋ丿
垎	各丿ㄋ丶丨
垯	大丶ㄋ丶丶
堎	厶丿丶丿ㄋ
墣	业丶丿一一
箖	林一丨丿丶
筼	口丨ㄋ丿丶
筶	告丿一丨一
簝	大丶丿丨ㄋ
筜	ㄋ一一一
鲝	鱼丿ㄋ丨ㄋ
蹾	ㄋ丨一丿
蹽	大丶丿丨ㄋ
宧	宀一丨丨ㄋ
痃	疒亠ㄋㄋ丶丶
痄	疒乍丿一丨一
痓	疒至一ㄋ丶一
荮	艹纟一丨丶丶
蒈	艹比丿丨ㄋ一
菍	艹今丶ㄋ丶丶
茽	荷中丨ㄋ一丨
荙	艹大丶ㄋ丶丶
茓	艹穴丶丶ㄋ丿
轷	车乎丿丶丿一
軎	車口丨ㄋ一一
蟓	虫象丿ㄋ丨ㄋ
蜐	虫去ㄋ丿丿丿
牮	代牛丿一一丨
伣	亻见丨ㄋ丿ㄋ
侹	亻壬ㄋ丶丶丶
俫	亻夹丨丿丶丶
猸	犭丨ㄋ一一
猹	犭木丨ㄋ一一
猄	犭京丶一丨ㄋ
猯	犭山一丿丨ㄋ
鞧	革酋丶丿一丨
韂	革厃丿丶丶一
弪	弓轻ㄋ丶一丨
弶	弓京丶一丨ㄋ
髃	骨日丨ㄋ丨一
鄘	广肀丨ㄋ一一
廆	广鬼丿丨ㄋ一
虍	虍丨一ㄋ丿一
虤	虍几丨一ㄋ丿
扂	户占丨一丨ㄋ
烶	火壬ㄋ丶丶丶
翈	甲羽ㄋ丶一ㄋ
缐	纟白丨ㄋ丿丶
斶	斤罒丿ㄋ丨ㄋ
钸	钅丨ㄋ丨丨
钷	钅匚丨ㄋ一一
铽	钅弋丶ㄋ丶丶
镎	钅合丿一一丨
锖	钅青一一丨一
铹	钅ㄋ丿丿丿
铥	钅丿一丨一ㄋ
訄	九言丶一一一
鼩	鼠勹丨ㄋ一一
嚆	口艹丶一丨ㄋ
噇	口立丨ㄋ一一
耠	耒合丿丶一丨
耢	耒ㄋ丿丿丿
耖	耒少丨丿丶丿
竘	立勹丨ㄋ一一
麖	鹿京丶一丨ㄋ
枅	木开一一丿丨
梌	木亼一丨丿丶
梾	木夹丨丿丶丶
榃	林田丨ㄋ一丨
榅	木日丨ㄋ丨丨
瞫	目覀丨ㄋ一一
犏	牜户丨ㄋ一丨
妭	女ㄋ丶丶丶
姶	女合丿丶一丨
婍	女大一丨ㄋ一
婤	女冂一丨一丨
婫	女日一ㄋ丿ㄋ
媂	女丨ㄋ丨丨
媓	女白一一丨一
媖	女艹丨ㄋ一丿
氕	气丿丿丿丿丿
昡	日亠ㄋㄋ丶丶
晊	日至一ㄋ丶一
泂	氵冂丨ㄋ一一
泃	氵勹丨ㄋ一一
洈	氵厃ㄋㄋㄋㄋ
溍	氵亚丨ㄋ一一
漈	氵一一丨丿
酅	山隹丨ㄋ丿丶
崌	山尸一丨丨ㄋ
嵅	山戊一丨ㄋ一
嵖	山木丨ㄋ一一
嶍	山羽丿丨ㄋ一
嶦	山厃丿丶丶一
砄	石丿丶丶丶
禚	礻丶丶丶丶
祋	礻殳丿ㄋㄋ丶
禤	礻罒ㄋ丶一ㄋ
祾	礻土丿丶丿ㄋ
罶	罒丨ㄋ一丨
撖	扌乛一丨丨一
扽	扌屯一ㄋ丨ㄋ
揳	扌丰ㄋ丿一丿
疁	田羽丿丶丿丿
鹝	鬲鸟丿ㄋ丶ㄋ
玹	王亠ㄋㄋ丶丶
珸	王五丨ㄋ一一
瑂	王丨ㄋ一一
瑅	王是丨ㄋ一一
瑔	王白丨ㄋ丿丶
瑝	王白一一丨一
瓀	王一丿丨ㄋ
釐	未攵一丿丨ㄋ
郚	五口ㄋ丨丨丨
歅	覀土丿ㄋ丿丶
邘	于阝ㄋ丨丨丨
鄑	亚日ㄋ丨丨丨
褯	衤广一丨丨一
厾	乙去一丨一ㄋ
鳆	鱼丨ㄋ一一
鲺	鱼丿丨ㄋ一
鳡	鱼戊一丨ㄋ一
鱾	鱼己ㄋ一ㄋㄋ
鄃	亼⺝丨丨ㄋ丨
勠	羽人丿丿丿ㄋ
霨	尸一一丨丿
脎	月乂一丨丿丶
膪	月丨ㄋ丨丨
腨	月山一丿丨ㄋ
脟	月爫一丨丶丶
胈	月ㄋ丶丶丶
鸼	舟鸟丿ㄋ丶ㄋ
鄀	艹丨ㄋ一ㄋ
鼒	才目ㄋ一丿丨
辿	山辶丶ㄋ丶丶
貆	豸一丨ㄋ一一
莝	艹从一丨一一
羓	巴ㄋ丨一ㄋ
羱	厂丿丨ㄋ一
荁	艹一丨ㄋ一一
鄌	广肀丨ㄋ一ㄋ
砠	石且丨ㄋ一一
蚆	虫巴ㄋ丨一ㄋ
豮	豕十一丨丨丨
陑	阝而一丿丨ㄋ
盷	目勹丶一一一
翷	米夕一ㄋ丨ㄋ
乸	也母ㄋㄋ丶一
佁	亻厶丨ㄋ一一
佸	亻舌丿一丨丨
倻	亻耳ㄋ丨丨丨
偡	亻其ㄋㄋㄋㄋ
僔	亻酋一丨丶丶
凘	冫其丿丿一丨
剅	豆刂丨丨丨丨
剋	古儿丨丨丨丨
呇	水口丨ㄋ一一
哃	口冂一丨ㄋ一
唝	口工丨ㄋ丿丶
圐	囗罒丶一ㄋ丿
圙	囗八一丿丨ㄋ
圢	丁一丨丨丨
圲	千丿一丨丨
坒	比土一丨一一
坽	令丿丶丶ㄋ
垙	光丨丶丿一
垵	宀ㄋ丿一一
埌	丶ㄋ一一ㄋ
埪	穴一丨一一
堌	囗一丨丨ㄋ
堧	土而一丿丶丶
堼	圭寸一丨一一
堽	罒一丨一丨
墘	一丿ㄋㄋ
妘	女云一一ㄋ丶
姈	女令丿丶丶ㄋ
婻	女十丨ㄋ丶丿
屾	山山丨ㄋ丨丨
峂	山夂丶丶丶丶
峱	犭丑丨ㄋ丨丨
崡	山了丶一丿丶
嶅	敖山丨ㄋ丨丨
嶟	山酋一丨丶丶
庤	广土一丨丶丶
廙	广田一丨丨一
悈	忄戈一丿丨丨
愭	忄耂丿ㄋ丨ㄋ
慥	忄告丶ㄋ丶丶
慬	忄堇一丨丨一
憕	忄癶一丨ㄋ一
戭	宀一丨ㄋ一丨
挓	扌宀丿一ㄋㄋ
旵	日山丨ㄋ丨丨
旿	日一丨丨丨
昄	日ㄋ丶丶丶
昤	日令丿丶丶ㄋ
昪	日厶一丿丨丨
晅	日一丨ㄋ一一
晱	日火丶丿丿丶
暅	日忄一丨ㄋ一
暕	日束丶丶丶丶
暲	日音一丨丨丨
杧	木亡丶一ㄋㄋ
枍	木八一ㄋㄋㄋ
柖	木刀丨ㄋ一一
栐	木丶ㄋㄋ丿丶
栴	木丨ㄋ丶一
梣	木山丿丶丶ㄋ
椪	木䒑丨丨丶丿
楪	木廿ㄋ一丨丿
櫆	木鬼丶丶一丨
毌	毌ㄋㄋ一丨丨
汈	氵一一一一
汫	氵井一一丿丨
沇	氵厶丿ㄋㄋㄋ
沘	氵比一ㄋ丿ㄋ
洢	氵亻ㄋ一一丿
洨	氵六丿丶丶丶
洭	氵匚一一丨一
浛	氵今丨ㄋ一一
浟	氵丿一丿丶
浭	氵更一丨ㄋ一
浲	氵夂一一一丨
涍	氵耂ㄋ丨一一
涐	氵我丿一丨一
涢	氵口丨ㄋ丿丶
淯	氵丨ㄋ一一
渼	氵一丿丶丶
湝	氵比丿丨ㄋ一
湣	氵民丨ㄋ一一
溇	氵米ㄋ丿一一
溚	氵艹丿丶一丨
溠	氵一丨一一
溵	氵ㄋ一一丿
滍	氵屮一丨ㄋ一
漴	氵山丶丶ㄋ一
漷	氵ㄋ丨一ㄋ
漹	氵正ㄋ一丶丶
潖	氵王一一丨一
潵	氵丨ㄋ一一
潽	氵䒑丨丨丶丿
澭	氵亠ㄋㄋ丿丿
瀔	氵一丿ㄋㄋ
瀱	氵罒一丿丶丿
灈	氵目丨ㄋ一一
炌	火人丿丨丨丨
炣	火可一丨ㄋ一
煁	火其ㄋㄋㄋㄋ
煃	火大一丨一一
熜	火丿ㄋ丶一
熥	火甬丶ㄋ丶丶
熻	火合ㄋ丶一ㄋ
燚	火火丶丿丿丶
爔	火一丨丿丶
牥	牜方丶一ㄋ丿
玒	王工一丨一一
玓	王勹丶丶丶丶
玶	王平一丶丿一
玿	王刀丨ㄋ一一
珇	王且丨ㄋ一一
珒	王聿ㄋ一一一
珕	王力ㄋ丿ㄋ丿
珖	王光丨丶丿一
珦	王丨ㄋ一一
珵	王口一一丨一
珹	王戊ㄋㄋㄋㄋ
琀	王今丨ㄋ一一
琎	王井丶ㄋ丶丶
琔	王定丶丶ㄋ一
琟	王隹丿丨丶一
琡	王上丨丿丶ㄋ
瑃	王丨ㄋ一一
瑆	王日丿一一丨
瑖	王段丿丨一一
瑬	氵丿丨ㄋ一
璒	王癶一丨ㄋ一
璥	王艹丿ㄋ丨ㄋ
璬	王白丶一ㄋ丿
畖	田瓜丿丿ㄋ丶
疭	疒从丿丶丿丶
癗	疒丨ㄋ一丨
皕	一白一丿丨ㄋ
砵	石木一一一一
膙	月弓丨ㄋ一丨
萳	艹十丨ㄋ丶丿
蔃	艹弓丨ㄋ一丨
薸	落覀一一丨丿
觃	见子ㄋ丨一一
陎	阝丿丨丿丶丶
齉	自畀一丨ㄋ一
慓	忄覀一一丨丿
琍	王禾丨丨丨丨
蠧	石丨ㄋ一丨
歔	虍业丿ㄋ丿丶
誌	言士丶ㄋ丶丶
砢	石可一丨ㄋ一
頔	由丆丨ㄋ一一
娭	女厶丿一一丿
嘢	口里ㄋ丶ㄋ丨
袴	衤大一一ㄋㄋ
毑	母也ㄋ丨ㄋㄋ
觍	曲八丨ㄋ丿ㄋ
坉	屯一ㄋ丨ㄋ
䣘	土ㄋ丨丨丨
鹐	臼丿ㄋ丶ㄋ
䢼	共阝ㄋㄋ丨丨
䎖	曾羽ㄋ丶一ㄋ
戣	癶天一ㄋ丿丶
劐	艹隹ㄋ丶丨丨
葴	艹戊一丨ㄋ一
苧	艹宀一丨丨丨
莿	艹朿丨丨丨丨
蒄	元一丨丶丶
䓨	缶丿一一丨
䓫	艹大一丨ㄋ一
徛	彳大一丨ㄋ一
虷	虫干一一丨丨
鬶	夫见一丨ㄋ一
㺄	犭亼丨ㄋ一一
旞	族丷一丿ㄋ丿
庱	广土丿丶丿ㄋ
馧	禾日丨ㄋ一一
穙	禾业丶丿一一
馝	禾日丶ㄋ丶丶
䅟	禾丿丿丿丿
焆	火口丨ㄋ一一
煓	火山一丿丨ㄋ
彐	彐ㄋ一一一一
䌹	纟冂丨ㄋ一一
䥽	钅发ㄋ丿ㄋ丶
鼱	鼠青一一丨一
䶮	龙天一一丿丶
毪	毛厶丿一一丨
鄚	莫阝ㄋ丨丨丨
㭕	木去一丨一ㄋ
棤	木龷丨ㄋ一一
椆	木冂一丨一丨
檞	木角ㄋ丿丿一
㛚	女甬ㄋ丶丨ㄋ
䢺	屮凵ㄋ丨丨丨
䴖	青鸟丿ㄋ丶ㄋ
昣	日人丿丿丿丿
漤	氵林ㄋ丿一一
瀌	氵鹿丶丶丶丶
饻	饣衣丶一丿ㄋ
硔	石共一丨丨一
㥄	忄土丿丶丿ㄋ
邿	土寸ㄋ丨丨丨
璮	王亠丨ㄋ丨ㄋ
鳤	鱼丶丶ㄋ丨
鲘	鱼一丨ㄋ一
翯	羽丨ㄋ一一
舥	舟巴ㄋ丨一ㄋ
碈	石氏丨ㄋ一一
禒	礻彑丿ㄋ丿丿
胣	月ㄋ丨ㄋㄋ
㑇	亻刍丿ㄋㄋ一
㑊	亻亦丶一丿丨
㕮	口父丿丶丿丶
㘎	口门ㄋ一丨丨
㙍	土双ㄋ丶ㄋ丶
㙘	土覀ㄋ丿一一
㙦	亼朩丶丶一丨
㛃	丰刀ㄋ丿一一
㛹	女亻一丨ㄋ一
㟃	山一丨ㄋ一
㠇	山京一丿ㄋ丶
㠓	山一一丿ㄋ
㤘	忄刍丿ㄋㄋ一
㧐	扌双ㄋ丶ㄋ丶
㧑	扌丶ㄋ丿丶丶
㧟	扌氵一ㄋㄋㄋ
㫰	日丶ㄋ一一ㄋ
㬊	日爫一一丿ㄋ
㬎	日ㄋㄋ丶丶
㬚	日丨ㄋ一一
㭎	木冂丿丶丶丶
㮾	丶丿ㄋ一一
㰀	木禾丿ㄋ丨丶
㳇	氵父丿丶丿丶
㳘	氵丿ㄋㄋㄋ
㳚	氵戊丶丶丶丶
㴔	氵刍丶ㄋ丶丶
㵐	水厂丶丿一ㄋ
㶲	火用丿ㄋ一一
㸆	火告丨一一一
㸌	火丿丨丶一
㻬	王一一ㄋㄋ
㽏	氵合一丨丨一
㿠	白光丨丶丿一
䁖	目米ㄋ丿一一
䂮	丰刀一丿丨ㄋ
䃅	石单丶丿丨ㄋ
䃎	石大丿ㄋ丶丿
䎃	冂土ㄋ丶一ㄋ
䏝	月二ㄋ丶丶丶
䏡	月示一一丨丿
䏲	月弟丶丿ㄋ一
䐃	月囗一丨丿丶
䓖	艹穴ㄋ丿丿丿
䓛	艹尸ㄋ丨丨ㄋ
䓬	艹⺊丨ㄋ一一
䕫	艹白丨一丨一
䗖	虫丶ㄋ丨ㄋ
䗛	虫丿ㄋ丶丨
䗪	度又丶丶丶丶
䗴	虫丿一丨一
䜣	讠斤丿丿一丨
䝙	豸区一丿丶ㄋ
䦃	钅艹一丨一丿
䲟	鱼一ㄋ丨丨
䲠	鱼丨ㄋ一一
䲢	月丿ㄋ丨ㄋ
䴓	一巾丿ㄋ丶ㄋ
䴔	六乂丿ㄋ丶ㄋ
䴕	歹刂丿ㄋ丶ㄋ
䴗	日犬丿ㄋ丶ㄋ
䴘	虍丿ㄋ丿ㄋ
䴙	辟鸟丿ㄋ丶ㄋ
侴	亼一ㄋ丨一一
傃	亻ㄋㄋ丶丨
叕	双双ㄋ丶ㄋ丶
咉	口冂一丿丶丶
圫	丿一ㄋㄋㄋ
坥	且丨ㄋ一一
垈	代土一丨一一
垏	聿ㄋ一一一
垺	爫ㄋ丨一一
垾	日一一丨丨
垿	广ㄋ丶ㄋ丨
埫	丨ㄋ丨ㄋ
堐	厂一丨一一
堾	丨ㄋ一一
塱	丶丿ㄋ一一
墕	正ㄋ一丶丶
墡	羊丶丿一丨
寁	宀一ㄋ一一丨
峏	山而一丿丨ㄋ
峛	山歹丨丨丨丨
崶	山圭一丨丶丶
弨	弓刀丨ㄋ一一
恔	忄六丿丶丶丶
愃	忄宀一丨ㄋ一
愐	忄面一丿丨ㄋ
揕	扌其ㄋㄋㄋㄋ
晪	日曲丿丶丶丶
暶	日族ㄋ丨一丿
暿	日壴丨ㄋ一一
朸	木力ㄋ丿丿丿
杄	木千丿一丨丨
栒	木勹丨ㄋ一一
棪	木火丶丿丿丶
楒	木田丶ㄋ丶丶
槜	木隹ㄋ丿丿丿
橞	木一丨ㄋ一一
泇	氵加ㄋ丿丨ㄋ
洓	氵朿一丨ㄋ丨
洘	氵耂一ㄋㄋㄋ
洣	氵米丶丿一丨
涄	氵由一ㄋㄋㄋ
溁	氵一丨丿丶
溹	氵ㄋㄋ丶丨
滧	氵六丿丶丿一
漋	氵阝丿ㄋ丶丿
漖	氵耂ㄋ丨一丿
潩	氵田一丨丨一
澪	氵丿丶丶ㄋ
澽	氵虍一丿ㄋ丿
濋	氵林ㄋ丨一丿
烠	火丨ㄋ一一
煋	火日丿一一丨
牻	牜尢丿丿丿丶
玤	王丰一一一丨
珋	王卯丿ㄋ丿ㄋ
珛	王丨ㄋ一一
珢	王艮ㄋ一一ㄋ
琈	王爫ㄋ丨一一
瑓	王束丶丶丶丶
瑧	王一丨丿丶
璱	王王一一丨一
癿	白乙ㄋㄋㄋㄋ
苉	艹匚丿ㄋㄋㄋ
茋	艹氏丶丶丶丶
萣	艹定丶丶ㄋ一
蚲	虫平一丶丿一
馞	禾日一丨丶ㄋ
鹲	一一丿ㄋ丿
粬	米曲丨ㄋ一丨
𬉼	火区一丿丶ㄋ
𠳐	口ㄋ丨丨丨
𥻗	米木丨ㄋ一一
𠙶	了凵ㄋ丨丨丨
𬣙	讠于一一丨丨
𨙸	十又ㄋ丨丨丨
𬇕	氵万一ㄋ丿丿
𬣞	讠宀一一一一
𬘓	纟川丿丨丨丨
𫭟	区一丿丶ㄋ
𫭢	人丿ㄋㄋㄋ
𫇭	艹丶ㄋ丿丶丶
𫐄	车一丿ㄋㄋㄋ
𫵷	山厂一ㄋ丿丿
𣲘	氵一一丿ㄋㄋ
𣲗	氵韦一一ㄋ丨
𬇙	氵贝丨ㄋ丿丶
𬣡	讠戋一一ㄋ丿
𫸩	弓区一丿丶ㄋ
𨚕	厶廾ㄋ丨丨丨
𫘜	马文丶一丿丶
𬘘	纟冖丿ㄋㄋㄋ
𫘝	马丿丶丶丶
𦭜	艹口丿丶丶丶
𬨂	车氏丿ㄋ一ㄋ
𬀩	日韦一一ㄋ丨
𬀪	日见丨ㄋ丿ㄋ
𬬩	钅弋一ㄋ丶丶
𫍣	讠冂一丨ㄋ一
𬣳	讠艮ㄋ一一ㄋ
𬩽	彐寸ㄋ丨丨丨
𬮿	阝己丿ㄋㄋㄋ
𬯀	阝文丿丨丨丨
𫰛	女轻ㄋ丶一丨
𬳵	马不一一一一
𬳶	马冂丨ㄋ一一
𫠊	马亠ㄋㄋ丶丶
𬍛	王丨丿丶丶
鿍	夂一ㄋ丨丨
𬜬	艹门丨ㄋ一一
𦰡	艹ㄋ丨丨丨
𪾢	目见丨ㄋ丿ㄋ
𪨰	山曲丨ㄋ一丨
𫓧	钅夫一一丿丶
𬬮	钅长丿一ㄋ丶
𬬱	钅斤丿丿一丨
𬬭	钅人丿ㄋㄋㄋ
𦙶	月古一丨丨ㄋ
𬘡	纟因丨ㄋ一丿
𬳽	马先丿一丨一
𬘩	纟丿丨一丨一
𪟝	贝ㄋ丿丿丿
𬍤	王彐一丨丶丶
𫭼	ㄋ丿丿丿
𬜯	艹丙丿丶丿丶
𬂩	木夹丿丶丶丶
𫠆	十又一丿丨ㄋ
𨐈	车光丨丶丿一
𬌗	牙合丿丶一丨
𫑡	口日ㄋㄋ丨丨
𪨶	山大一ㄋ一丨
𬬸	钅木丶丶丶丶
𬬻	钅⺊ㄋ一丿丿
𬬹	钅日丨丨丨丨
𬬿	钅刀丨ㄋ一一
𬭁	钅母ㄋㄋ丶一
𫢸	亻单丶丿丨ㄋ
𫗧	饣束一丨ㄋ一
𬊈	火彐一丨丶丶
𬒈	石一丿丨ㄋ
𨺙	阝臼丿ㄋㄋㄋ
𬳿	马亼一丨丿丶
𫄨	纟乂一丿丨ㄋ
𬘫	纟宀一一丿ㄋ
𫮃	单丶丿丨ㄋ
鿎	石大丶ㄋ丶丶
𬱖	由页一丿丨ㄋ
𬟽	虫丨丿丶丶
𫓯	钅圭一丨一一
𫟹	钅共一丨丨一
𫟼	钅大丶ㄋ丶丶
𠅤	亠田丶ㄋ丶丶
𬇹	氵囗一一丨一
𬍡	氵㇡丿丿一一
𬤇	讠覀一丨一一
𫍯	讠戊一丨ㄋ一
𬤊	讠是丨ㄋ一一
𫍲	讠臼丨ㄋ丶丶
𬯎	阝丨ㄋ丿丶
𬘬	纟青一一丨一
𬘭	纟林一丨丿丶
𬴂	马非丨一一一
𫘦	马勹丿一一丨
𫟅	纟京丶一丨ㄋ
𬘯	纟ㄋ丨一一
𫘧	马丨ㄋ丿丶
𪣻	米ㄋ丿一一
𡎚	户丨ㄋ一丨
𬃊	木一丨丨ㄋ
𬷕	甫鸟丿ㄋ丶ㄋ
𫐐	车臼丿ㄋㄋㄋ
𬹼	齿人丿丨丨丨
𧿹	母ㄋㄋ丶一
𫶇	山丶ㄋ丨ㄋ
𫖮	山己一丿丨ㄋ
鿏	钅丿ㄋ丶丶
𬭊	钅木一丨一一
𨱇	钅求一丨丶一
𫓶	钅口丨ㄋ一一
𬭎	钅宀一丿ㄋ丶
𫖯	儿一丿丨ㄋ
𬱟	厃一丿丨ㄋ
𫛭	犭王丿ㄋ丶ㄋ
𫷷	广钅丿ㄋ丿丶
𬮱	门覀一丨一一
𬊤	火单丶丿丨ㄋ
𣸣	氵十一丨丨丨
𬴃	马丰一丿丨ㄋ
𫘨	马是丨ㄋ一一
𤧛	王丨ㄋ丨丨
𬪩	酉农丶ㄋ丿ㄋ
𬒔	石止丨ㄋ一一
𬨎	车酋丶丿一丨
𫐓	车矛一丨丿丶
𫫇	口亚丶ㄋ丶丶
𫓹	钅其一丨丨一
𬭚	钅ㄋ丨一一
𬭛	钅氵ㄋ丿丨ㄋ
𬕂	工丨ㄋ丿丶
𬶋	鱼勹丨ㄋ一一
𬶍	鱼宀丿ㄋㄋㄋ
𦝼	月米ㄋ丿一一
𫔶	门自一丨丿丶
𫌀	礻丨ㄋ丿丶
𫖳	尹口一丿丨ㄋ
𫘪	马厂丿丨ㄋ一
𫘬	马爫ㄋㄋ丶一
𫞩	王艹一丨ㄋ丿
𡐓	广ㄋ一一丨
𪤗	羽丿丶丿丿
𣗋	丿ㄋㄋㄋ
𬸘	匚日ㄋ丿一丿
𬒗	石丨ㄋ丿ㄋ
𥔲	石吅一一ㄋㄋ
𫚖	此鱼丿ㄋ丨ㄋ
𨱏	钅艹丿丶一丨
𬭤	钅亻ㄋ一丿一
𫚕	鱼一丨ㄋ丨
𬶐	鱼儿丶一丿丶
𬶏	鱼厃ㄋㄋㄋㄋ
𩽾	鱼宀ㄋ丿一一
𬸚	犭讠一丿丶丶
𬤝	讠一丨ㄋ一一
𬙂	纟宀一丨ㄋ一
𬭩	钅公ㄋ丶一ㄋ
𩾃	鱼丿ㄋㄋㄋ
𬸣	寒鸟丿ㄋ丶ㄋ
𫍽	讠罒一丨ㄋ一
𬴊	马米丿ㄋ丶一
𬞟	艹止丨丿丿一
𥕢	石一丨ㄋ一丨
𫟦	车丷一丿ㄋ丿
𬺈	齿大一丨ㄋ一
𫠜	齿臼丿ㄋㄋㄋ
𪩘	山十丨ㄋ丶丿
𬭬	钅丰一一一丨
𨱑	钅丨ㄋ一丨
𬭯	钅㡀丿一丿丶
𫗴	饣亠丨ㄋ丨ㄋ
𬸦	族疋丿ㄋ丶ㄋ
𫄷	纟音丶ㄋ丶丶
𤩽	王十丨ㄋ丶丿
𬭳	钅壴丨ㄋ一一
𬭶	钅黑丨ㄋ丶丿
𫔍	钅釆丨ㄋ一丨
𬭸	钅米丿ㄋ丶一
𨱔	钅酋一丨丶丶
𬭼	钅丷一丿ㄋ丿
𫔎	钅矛丨ㄋ丿丶
𬸪	釆田丿ㄋ丶ㄋ
𬶟	鱼束丨丨丨丨
𬶠	鱼束丶丶丶丶
𬶨	旡丿ㄋ丨ㄋ
𦈡	纟一丿丨ㄋ
𫄸	纟千丨ㄋ丶丿
𬟁	艹鬲丿ㄋ丶ㄋ
𥖨	石口丨ㄋ一丨
𦒍	立里ㄋ丶一ㄋ
𬙊	纟黑一丨一一
𬶭	鱼一一丨丿
𩾌	鱼广ㄋ一一丨
𨟠	目目丿丨丶一
𬶮	鱼壴丨ㄋ一一
𨭉	文一一ㄋ丶丿
𬙋	纟亠丨ㄋ一丨
𤫉	王火丶一一一
𬺓	齿林ㄋ丨一丿
𫚭	鱼巛丨ㄋ一ㄋ
屄	尸穴丶丶ㄋ丿
逎	酉辶丶ㄋ丶丶
	
	
	
	
	
	
	
	
	
	
	
	
	
	
	
	
	
	
