的	dk
一	je
了	cu
是	si
不	he
我	wo
他	jd
在	dl
人	do
有	dh
这	nr
来	wn
你	ja
个	dj
上	li
到	gn
大	ke
道	aj
着	kb
说	sk
她	md
们	jf
也	du
就	lx
那	sy
地	ld
中	vi
子	su
出	ys
要	tm
下	le
为	jw
得	fq
和	ck
么	jc
时	wj
可	ge
去	we
会	dm
里	gi
过	jr
以	bu
看	nb
然	bp
对	fj
自	jo
好	ms
天	fe
之	kr
没	nd
都	fy
小	ci
心	lr
能	ch
还	hr
而	ye
后	al
想	vl
起	mg
生	go
家	vh
只	kf
多	bb
手	no
事	ls
面	heo
国	ks
头	wk
发	xu
如	mk
无	jx
身	zo
用	to
又	fu
把	gg
样	tk
开	ne
于	ae
点	tn
前	ar
已	gu
知	vk
什	jp
所	av
方	mr
现	sf
经	xp
见	fi
成	kt
些	ty
法	nw
行	fa
声	lz
年	vj
意	ml
己	gue
当	cc
但	jq
笑	lf
老	fn
两	ff
很	fh
情	hh
从	fo
作	jz
动	mw
话	sn
回	xi
力	wu
儿	xo
三	pe
长	bo
走	me
明	wh
间	fw
同	sl
分	so
气	vo
十	pei
眼	bh
女	mu
将	zb
定	pr
种	cv
进	yr
本	tj
此	ti
向	zk
正	kei
真	hf
实	vw
给	xc
高	gk
被	hz
学	ns
问	fk
神	hw
与	qj
再	fl
才	te
全	ds
太	kj
因	qi
其	gei
主	kre
日	wi
打	ga
却	ww
让	sli
文	nre
最	wy
口	ki
听	kq
外	bl
二	yee
门	fr
几	ao
理	sg
公	co
等	ll
相	ve
光	hi
西	tei
白	doi
先	goe
者	fei
便	jb
住	jk
使	jl
并	an
重	ng
信	js
斯	gq
感	kl
做	jv
水	ni
新	ht
风	ah
应	am
少	vio
边	wr
觉	nf
色	dg
别	kw
名	bk
特	cl
何	jg
次	pre
山	yi
机	ta
吧	kg
位	jh
比	meu
关	ak
体	jt
部	hk
第	lxi
果	wt
马	au
死	bn
处	nl
怎	zl
安	vm
东	yc
像	jwo
四	ciu
工	lei
王	se
更	be
月	ho
由	ai
金	vor
呢	kz
尔	aou
直	hei
数	qm
内	liu
它	vn
路	zz
快	hv
美	kk
叫	kbu
吗	ka
军	qy
接	gh
加	tu
平	her
张	xb
望	xh
常	cy
放	mn
表	xj
难	fm
性	hg
入	dor
场	lt
算	lb
海	nv
脸	hq
花	fyo
龙	leo
连	yrr
战	tke
轻	yp
爱	yd
夫	jee
利	cn
带	fqi
亲	hte
合	cor
通	tr
清	nh
立	hre
候	jvo
目	bi
民	qu
系	jdu
拉	ghr
变	pf
五	jei
原	ad
完	vle
结	xn
化	yo
跟	zh
世	dp
空	dle
受	yf
车	yeu
教	fs
今	qo
业	ji
啊	ky
许	sv
强	xk
飞	pw
德	fp
解	hs
电	wp
量	qg
思	gl
总	klr
任	jso
物	cj
度	df
活	nn
件	jco
林	mei
师	nj
非	zi
克	vx
象	wou
万	weu
该	sh
命	qk
士	leie
似	jbu
城	lk
至	geu
吃	kv
提	gs
转	yy
制	vy
市	by
黑	xiu
火	pro
云	mee
报	gw
指	gni
书	tt
远	lrr
找	gke
满	nfe
记	sgu
管	lv
干	nee
计	sp
且	biu
红	xl
房	tmr
步	hc
必	lj
微	aa
南	ps
字	vs
反	af
华	ype
百	jdo
言	sr
李	ts
认	sd
往	fkr
形	nwo
服	hwu
倒	jgi
离	ql
刚	shi
虽	kbi
罗	cb
双	fur
告	joe
站	hti
乎	bor
流	nx
或	kke
坐	fle
深	nq
冷	wq
各	zou
传	jy
音	mre
息	jlr
石	de
及	sou
保	jsi
语	sj
剑	qmi
交	qh
若	fd
容	dd
怕	hd
条	nt
界	gd
半	jro
达	krr
奇	kge
青	hee
题	sne
早	wpe
元	lee
建	sru
失	jj
近	qr
惊	hl
则	dn
魔	yso
即	tw
队	ydo
程	cke
切	nsu
衣	jre
谁	sm
北	zie
落	yz
杀	htei
式	kle
精	qhe
酒	nte
产	ha
请	she
论	sa
统	xx
决	wv
星	wg
义	nro
刻	hn
极	tso
未	dee
求	wei
随	ydi
竟	mx
格	tz
影	wl
每	vv
区	meo
兴	mf
紧	mdu
兵	qf
办	wf
展	zp
始	mc
八	for
功	lw
武	jki
政	kn
喜	aki
拿	cno
孩	shr
男	gwu
员	kd
灵	cp
阿	yg
务	nwu
江	nle
钱	vke
根	th
图	knr
布	dy
您	jar
令	qor
突	dpe
设	sdo
据	gz
绝	xd
收	bno
越	mke
整	zn
基	gle
院	yv
姐	mb
父	lo
怪	hfe
期	gho
术	tjr
暗	wm
九	gou
店	at
乐	pc
识	sko
友	dfu
般	pd
片	ko
七	neu
尽	kwr
哪	ksu
集	mt
阳	yw
客	vz
伤	jvu
答	lc
夜	bj
领	qn
千	noe
周	snei
装	zlr
写	qq
苦	fv
血	jci
视	hfi
击	lsu
取	yfu
消	nc
司	tl
弟	xr
哥	gge
玉	sjr
静	hb
阵	yye
单	hro
亚	sei
代	boi
运	mrr
六	qre
众	dfo
品	kh
足	km
族	dv
科	cw
类	qke
雷	pg
断	qp
社	hle
留	pgi
晚	wwo
兰	ay
谈	spr
器	hp
准	wmo
够	kko
确	dho
易	wjo
黄	pa
复	vwo
送	akr
团	kte
句	kki
官	vhi
敢	tyo
修	jn
照	ws
丽	ce
备	ngi
急	xlr
忙	hx
母	vu
欢	fao
英	fse
古	vei
底	amr
巴	gui
帮	xy
终	xnr
势	dw
娘	mj
热	dnr
显	wji
朝	xho
错	vp
持	glei
调	ss
宝	vsr
香	cwi
低	jm
丝	pp
曾	wro
冲	wvi
线	xke
级	xs
示	see
改	gno
待	flei
包	kgu
台	cki
沉	nqo
愿	adi
久	tou
希	hdi
木	teio
响	kzi
破	dz
首	ajo
模	tye
脚	hwui
害	vxi
约	xkr
资	pdi
穿	da
联	ya
哈	kc
树	tf
雪	pcu
楚	mm
注	nk
引	xji
护	gt
另	kwu
故	vno
村	tje
存	dsu
嘴	kto
依	jjr
诉	sq
造	jrr
技	gp
露	pz
除	yq
慢	hwi
具	bf
摇	gy
观	ffi
楼	tq
商	hso
型	nne
府	aje
停	jge
爷	lwu
铁	vje
段	goi
广	are
念	qlr
组	xbi
节	fwu
需	py
议	snr
举	mfe
支	pfu
细	xg
跑	zku
维	xm
异	gne
陈	yyi
乱	np
况	wko
忽	jlru
妈	ma
刀	suo
痛	ltu
群	ckr
居	zv
速	zr
兄	kx
睛	bhe
究	dgo
斗	wpei
卡	lli
甚	gpu
帝	hy
喝	kwo
态	kjr
怀	hhe
局	zt
派	na
杨	tto
谢	sz
脑	hqr
病	lfo
顿	bne
治	nci
福	hli
角	hou
旁	hm
威	kju
叶	kp
京	lre
围	kje
园	klee
皮	zu
雨	peiu
号	kwe
密	vlo
须	wne
推	gm
背	zhi
河	nge
亮	gao
姑	mv
证	ske
费	xni
汉	nfu
志	llr
查	tqi
圣	fleie
呼	kbo
讲	sye
续	xpu
标	tse
共	peii
尼	zno
米	qro
际	yse
招	gsi
超	msi
差	klei
仍	jwu
块	lvo
莫	yei
游	ndu
药	fx
船	pai
网	sho
掌	cnoe
呀	kae
掉	gli
皇	dse
玩	sle
梦	mbo
选	gr
争	bou
疑	nvu
既	tne
波	nz
闪	fdo
室	vg
料	qw
简	lfi
佛	jxo
堂	cle
索	bd
规	jfi
朋	hho
攻	ln
章	mp
礼	hpu
鬼	soi
春	lwi
刘	nni
严	sjo
赶	mne
睡	bz
屋	zg
食	po
饭	pau
济	nno
试	skei
仙	jyi
导	gj
参	cwo
沙	nvi
永	jtu
肯	hhi
环	sheo
农	lru
恶	slr
称	ca
止	hie
初	hsu
医	vvo
敌	nnoe
跳	zx
假	jqu
左	dlei
散	ph
温	nwi
继	xq
换	gdi
权	tfu
银	vhu
君	ckiu
退	hrr
闻	fye
激	ndr
画	jgu
较	yqo
烈	bnr
独	pb
球	sw
土	leiee
层	zm
卫	wje
抱	gku
草	fwe
专	yt
烟	pq
余	qt
秋	cpr
顺	wneo
顾	ag
否	hki
值	jhe
考	fqe
冰	wni
境	lm
妹	mde
恐	la
怒	clr
伯	jdoi
质	ap
艺	fpu
味	kde
历	aw
构	tku
研	dne
施	ddu
贵	ldi
委	cm
渐	ny
淡	npr
史	kho
校	tqo
狂	pse
馆	pv
板	tau
排	gzi
价	jdoii
街	fhe
宫	vki
追	jhr
靠	jzi
忍	sjru
普	aji
致	gnoe
钟	vvi
娜	msu
耳	yeii
属	zj
忘	xlru
苏	fwr
伙	jpr
仅	jfu
景	wlr
松	tc
州	wnr
胡	vho
纪	xgu
印	pj
赵	mh
置	che
投	gdo
列	bni
隐	yx
缓	xye
座	afe
庄	ale
幸	lkr
副	lg
充	xxo
守	vjei
胜	hgo
救	wno
射	zje
齐	nnoi
顶	ane
助	bw
右	dki
素	xdu
唐	as
抓	gyo
巨	vvu
毛	woe
诗	slei
弄	sneo
防	ym
雅	amo
源	nao
户	tru
湖	nvo
项	lne
党	cx
压	alr
寒	hwr
效	qho
奥	zq
毫	gwo
增	lwr
险	yqr
状	zpe
按	gv
买	twe
禁	mse
阴	yh
叹	kfu
蓝	fli
察	vye
承	cpu
省	vb
份	jsor
托	gje
恩	qlru
责	xdi
挥	gqe
洛	nzo
妇	mcu
牛	coe
习	yu
警	dko
默	xpe
岁	yb
骑	ake
股	hdo
划	kni
负	ddi
枪	td
梅	tv
采	yte
吸	kso
富	vli
舞	vf
肉	ldo
镇	vhor
野	ghu
床	ate
某	dt
醒	two
验	aq
读	spu
担	gqi
毒	xv
封	hj
尚	cs
纳	xli
伊	jcu
营	wki
猛	psi
短	vhe
旧	jwi
脱	hko
遇	wlru
词	st
坏	lh
控	gde
田	giu
乡	pjo
刺	qni
啦	kgr
孙	sc
翻	mgu
藏	fku
虎	dao
坚	mle
良	jhu
柔	hteio
眉	zbi
伸	jwii
窗	dzo
咱	kjo
婚	mmi
戏	fke
逃	xnru
赛	hdiu
扬	gto
凡	ajr
凌	wlo
配	tg
练	xyu
率	bpr
贝	di
宇	va
茶	fde
优	jxr
杰	tnr
吉	nei
卷	lgu
创	dgi
罢	cwe
秀	cwu
归	ncu
哭	hpe
凤	afu
陆	yl
端	hye
休	jte
库	aye
序	ahu
善	kai
秘	clo
拍	gdoi
案	vme
迷	qrr
震	pye
免	wx
职	yk
洋	nkr
寻	cje
养	kjoi
珠	sje
歌	ggo
盘	pci
朱	jde
演	nve
虚	dji
呆	siu
付	jje
笔	lwo
适	nrr
康	ac
麻	yre
宁	vae
吴	kfe
欲	fdi
罪	cz
恨	hhu
杂	gte
套	kbe
骨	mi
紫	tdu
软	yao
蒙	wjeo
弹	xhr
育	xhi
企	dhi
仿	jmr
泪	nbi
曲	aiu
鱼	dou
兽	wge
略	gzo
握	gze
厅	aae
厉	awe
卖	pt
供	jpe
丹	sb
喊	kkei
峰	yn
灯	pae
绿	xci
夏	db
塔	lfor
桌	lwe
范	ygu
限	yhu
县	bc
讨	sjei
革	qe
燕	dkie
欧	mao
临	nvr
移	cbo
洞	nse
剧	zvi
油	nai
束	ze
替	jji
概	tte
秦	lco
协	pwr
材	ttei
魂	mso
织	xko
智	vkiu
诺	sfe
爵	ycu
丁	aei
劳	wwu
律	fsu
瞧	bm
丈	djr
尊	dje
摆	gc
彩	yto
输	yqi
败	dno
抬	gci
徐	fqei
熟	gso
森	tme
探	gqo
毕	mpe
预	hne
雄	dc
测	ndi
牙	aeu
混	nwe
升	jne
甲	aiue
祖	hbi
瑞	syeo
例	jbi
迎	pwru
胸	hkor
晓	wpeu
透	cwr
鲁	dwi
架	tteio
纸	xmo
洗	ngo
浪	nju
亦	preo
抗	gb
烦	pn
班	snee
盖	kci
宗	vse
塞	hlei
登	yhe
墙	lp
闲	ft
烧	ppe
硬	dbe
危	hgu
肩	thi
午	vpe
妙	mvi
偷	jqi
互	jau
荣	wte
含	qki
检	tqr
执	dei
菜	fyei
柳	tp
域	lki
伦	jao
灭	jpro
席	dyi
莱	fwi
编	xt
益	afi
呵	kgei
摸	gye
弱	xw
闹	fb
徒	fme
述	tjru
货	ydiu
博	pfe
劲	pwu
宣	vji
姓	mgo
操	gki
获	fpe
懂	hfo
萧	fso
蒂	fhi
著	ffe
妻	jsu
鲜	dkr
旅	djo
敬	dkoe
趣	my
避	br
亡	xre
释	mfee
积	cko
圆	kkiu
杯	the
牌	kdo
批	gme
阶	ydoi
爸	lgui
占	tie
拥	gtou
辈	zy
困	ktei
腿	hhr
杜	tle
横	tpi
扑	glir
抽	gai
羽	yur
借	jpi
妖	mfo
征	fkei
莉	fc
吓	kleir
策	lq
犯	pgu
袋	bjr
狠	phu
骂	hau
曼	wc
纷	xso
虑	dlr
婆	nzu
奶	mwu
挂	ghe
拜	nje
码	dau
悲	zlru
佳	jhei
财	dte
桥	tfo
盛	kti
怜	hqo
奔	kpe
玛	sau
勒	qwu
介	dnoi
厂	aeo
巧	lweu
狗	pk
尖	ckeo
勇	twu
泰	lni
冒	wb
轮	yaor
谷	fdiu
菲	fz
孔	spuu
庭	asu
监	lci
伟	jjee
健	jsur
尤	xjr
暴	wpi
络	xz
丰	xe
餐	lbu
唱	kwi
偏	jti
误	skee
哼	kgui
飘	tsou
岛	fyi
凝	wnoe
迪	arr
萨	fyr
聚	yfo
惜	hpi
狼	pju
诚	sku
闭	fte
缘	xa
碰	dai
迹	prr
折	meie
篇	lti
庆	akeo
洲	nwr
凯	ygo
残	bke
稳	cxr
鼓	apu
腰	htu
诸	sfei
韩	xje
版	kau
附	yj
叔	lcu
沈	nqou
瓦	jeu
唯	kmo
降	yne
挑	gx
镜	vmo
访	smr
姆	mvu
舒	qv
犹	px
补	hlir
港	npu
幽	ypu
豪	gheo
殿	zpo
宽	vfi
郎	jtui
哦	kwoe
评	sher
灰	dpr
缺	yvo
玄	bpu
厚	awu
私	ccu
臂	bhi
艾	fho
谓	sgi
妮	mz
训	swo
舍	qve
遍	tlr
孤	syo
颜	hao
陪	yhi
拳	lno
奋	kgi
迟	krru
竹	loe
仇	jgo
稍	cci
遗	ldr
判	jni
戴	qge
讯	spe
汽	nvoe
乔	fno
疯	lao
壁	ble
献	psr
芳	fmr
番	mgi
凭	jsou
胆	hqi
琴	sso
尘	clei
挺	gsu
弃	xne
仁	jye
乌	ktee
碎	dbo
搞	ggi
录	cni
赞	ggiu
迅	ppr
佩	jae
童	hgi
邪	ayu
择	gf
嘛	kyr
躲	za
朗	jto
宋	vt
逐	hrru
忠	vlr
吹	kao
摩	yno
幻	ptu
朵	atei
欣	qa
抢	gdu
埃	lcoe
炼	pyu
纯	xbe
典	afo
躺	zc
泽	nfee
针	vpei
圈	klu
皱	xzu
糊	qvo
固	kve
锋	vne
乃	wuo
均	lkre
凉	wlre
浮	nyu
触	hbiu
唇	yki
页	neo
娇	mfoi
隔	yle
纵	xf
绍	xsi
昨	wz
蛋	mbi
侧	jdi
悄	hci
荡	ytoo
伴	jjro
箭	lar
咬	kqo
迫	dr
累	gduu
傲	jke
扎	gpuu
载	qye
鸟	fou
饰	pvi
腾	hlu
撞	ghi
惨	hco
猜	phe
努	cwuo
珍	sdoo
尸	zue
滚	nqu
插	gnoi
氏	mo
吻	kjou
扫	gcu
川	woi
丢	jwe
抵	gmr
减	wke
池	ndui
彼	fzu
莲	fyru
票	tsee
伏	jpeo
粉	qs
昏	mwi
刊	nnii
鼻	jgiu
阻	ybi
臣	qei
梁	nsr
奈	kse
翼	yge
逼	lgr
晶	wwi
嘿	kxi
粗	qb
忆	hpuu
弗	xno
吐	kleie
盯	ba
央	skeo
曰	wiu
麦	xnou
缩	xvo
盟	whi
瞪	bye
距	zvu
芒	fxr
符	lje
堆	lmo
忧	hxr
鸡	ffo
幕	yyiu
爆	pwe
挡	gcue
晨	wye
颗	wteo
旋	dmu
振	gyeo
净	wbo
析	tqoo
惯	hvi
赫	cce
辛	nrer
钢	vso
敏	vvoe
苍	fdu
描	gfi
赏	cd
款	lso
凶	hsui
颤	bx
洁	nnei
陷	ydoie
损	gkiu
汗	nnee
谋	sde
径	fpur
夺	kjei
鞋	qhei
延	jhur
莎	yvi
漂	ntee
抖	gwe
遭	jai
瞬	byo
坦	lqi
愈	qhi
椅	tkei
岸	yae
裂	bnre
洪	npe
途	qtr
剩	czi
额	vze
销	vc
磨	yde
贴	dti
季	csu
享	gsui
赤	cei
吟	kqor
愤	hpei
醉	tb
枝	tpu
慕	yci
壮	zle
隆	yneo
仔	jsui
恢	hdr
乘	czie
穷	dwu
映	wse
皆	mdo
扶	gjee
阁	fzo
俊	jcor
漫	nwiu
祥	hkr
桑	ffei
岂	ygue
堡	jse
惑	kker
貌	ddo
袭	ljr
仰	jpu
嘉	atu
鸣	kfo
邦	xyui
岳	qyi
琳	sme
滑	nm
跃	zf
宜	vbi
俩	jfo
毁	tlo
汇	nveu
绕	xpeu
慧	xxu
逸	wxr
怨	bg
御	fvi
唤	kdi
闷	flr
荒	fxo
爬	ygui
厌	ape
傻	jzo
薄	yfe
旗	dge
涌	ntu
雾	pnu
羊	kro
吕	kkiue
仪	jnr
匆	jjrr
泉	dni
拖	gvu
零	pqo
孟	sci
贼	dke
骗	ati
辉	hqe
尾	zw
恋	pl
融	lbi
锁	vci
耐	yje
核	thr
铺	vfe
炸	pzo
末	deei
拼	gae
慌	hfr
枫	tao
启	tki
冬	nwrr
潮	nxo
甘	deii
帐	ybo
暂	yqiu
睁	bbo
翠	ybor
汤	nto
郑	aku
寂	vlio
掩	gkiue
宾	vq
译	sfee
促	jkie
递	xrr
踪	zve
炮	pku
扩	gar
旦	qiu
倾	jneo
垂	zoe
侯	jvoe
郭	gsuii
括	gnoei
审	vwi
督	lcur
浓	nlr
匹	vxo
胖	hjr
培	lhi
潜	njee
嗯	kqr
宏	vd
戒	kne
尺	ku
彻	fnu
蛇	bv
擦	gvo
晃	whir
侍	jle
羞	kaui
拔	gdur
慰	zs
课	swe
聊	ypo
爹	lbo
亿	jpuu
疾	lvoe
航	pbo
浑	nqe
绪	xfe
惠	jwie
舰	pfi
泥	nzou
狱	pseo
沿	naiu
斜	qtrr
贸	pdiu
箱	lve
奉	lle
轰	yfur
俗	jfor
辞	nnr
劝	fwuo
拒	gvue
鸿	nlo
墨	xle
伍	jjei
弯	pxu
贫	sdi
键	vsu
盗	pciu
湾	npue
浩	njo
吼	ksuu
颇	zne
奴	cuo
祝	hkou
牧	cnoeo
授	gyu
愁	cpru
霍	pm
俄	jwoe
侠	jwor
帕	ydoiu
哀	gjo
抚	gjeo
奖	zbe
疼	lnr
耶	yyu
惧	hbo
姊	mxo
召	ski
饮	pao
悉	mlr
染	ngei
卢	lzu
偶	jwiu
废	ax
酸	tco
津	nsue
扭	gau
辆	yfor
悠	jnru
碧	sdeo
脉	hju
踏	zni
撒	gpi
傅	jfe
黎	ckoo
井	yeeo
挤	gnoii
询	skiu
愣	hcr
讶	sae
暖	wyee
聪	ykr
夹	wd
赖	zd
筑	llo
炎	ppro
予	hu
恼	hqre
鹰	ajoi
埋	lgi
嫁	mve
猫	pfiu
仆	jli
帽	ywi
廷	srur
焦	mnr
扯	ghie
敲	gkie
幅	yli
虫	biue
瓶	aneu
础	dyu
冥	qwr
仲	jvi
焰	pdo
倍	jhi
岩	ydeo
董	fni
吞	fki
痕	lhu
丧	pauo
曹	jaiu
牢	vco
甜	nde
钻	vti
悔	hvu
昌	wwiu
肚	hleie
恰	hcor
庞	aleo
粮	qju
屈	zyu
熊	cho
缠	xai
赌	dfe
韦	jeeu
霞	pqu
璃	sqi
膀	hhre
耀	hyo
喷	kpei
挣	gbo
寄	vkei
溜	npi
亭	gaei
泛	njr
罩	cli
冠	qle
遥	yyr
尝	cq
荷	pge
瘦	ltiu
唉	kco
劫	wwuo
拾	gco
欺	gaou
恭	pcir
估	jve
梯	tx
锦	vdi
艳	xdui
搭	gfo
辑	yke
肃	sno
帅	nyi
烂	paee
锅	vkiuo
俱	jbo
浴	nfo
桃	txr
措	gpiu
昂	wpu
搜	gti
姿	pmu
轩	ynee
穴	drr
殊	bje
郁	dhu
铜	vsei
疗	lcui
陵	ylo
亏	ytu
扰	gxr
娃	mhe
竞	hkouu
截	qmo
牵	kqoe
堪	lguu
锐	vko
惹	fdiue
悦	hkouuu
渡	ndur
衫	hwo
坡	lzuo
频	hce
税	ckou
抹	gdee
袍	hku
宿	vjeo
滴	nhi
霸	pqou
鹏	hhou
忌	glr
喃	kpi
袖	hai
悟	hji
柱	tkr
陶	yko
申	wjii
漠	nye
纹	xnre
涂	nqei
迈	wrr
跪	zhu
繁	vvoeo
燃	pbe
寺	ljei
驾	tauu
搬	gpo
勃	bs
吾	jkiu
肥	hgui
贤	mdi
怔	hke
允	cxo
链	vyr
详	skr
障	yme
湿	nwii
寿	xjei
播	gmi
缝	xnee
辰	yeo
舌	noei
喂	kgeu
瑟	ssr
猎	ppi
啸	ksoi
扇	tyu
储	jsei
润	nfeei
丛	fje
函	cnu
灾	vpr
慈	apuu
购	dku
戈	keu
痴	lvi
返	afr
浅	nke
晴	whe
卧	qli
勾	kcu
玻	szu
卓	lwei
扔	gwuo
炉	ptr
脆	hhuu
矮	vcu
喘	kye
姜	kmu
捉	gkieo
抛	ggu
葛	fwo
扣	gkiuee
盾	api
勤	ywu
霜	pve
玲	sqo
恒	hjiu
厨	ahe
冯	wa
躯	zvo
乖	nzi
刑	nniii
芬	fsor
侵	jcr
薇	faou
扮	gsor
狐	pyo
丫	wjiii
幼	pwuo
耸	fyeii
捕	gfe
脏	hae
沟	nku
丑	aui
签	lqr
仗	jdr
茫	yxr
辱	yjei
邓	fyu
齿	hiei
嘻	kaiu
崇	yve
翔	kyu
斩	yqoo
猪	pfei
笼	lleo
糟	qji
贯	vdiu
液	nbo
盈	wfi
肤	hje
媚	mzi
拦	gaee
屏	zae
咒	haou
拟	gbu
涉	nhio
嫂	mti
援	gyee
违	jrru
柏	tdo
趁	mdoo
僧	jwr
衡	fdiuei
阔	fnoe
摄	gyur
瓜	yoo
赢	ydiuo
矿	dar
裁	qjr
刹	htii
疲	lzuoi
柯	tge
豫	hwou
晕	wqe
溪	nyuu
币	jyiu
淑	nli
贺	tdi
弓	xue
勉	wxu
桂	thei
懒	hzo
雕	snoi
巡	wrru
庙	aai
碗	dvo
铃	vqo
裤	haeu
挨	gcoe
掠	glre
豆	heiu
寸	jeir
誉	mfr
串	kvi
割	vxiu
腹	hviu
驱	ame
奏	lfe
甫	feiu
植	theii
诱	scu
订	saei
蕾	fpi
罚	csi
披	gzu
覆	tfoe
悬	bcr
涛	nxe
眨	bjru
柜	tvu
矩	vvue
欠	aouo
怖	hdiui
棋	tgei
贾	tdiu
穆	cdi
姬	mq
柄	tfor
饿	pwo
琪	sge
邻	qyu
姨	mku
驻	akre
愧	hsoi
爽	khor
跌	zjee
弥	xao
污	nyuuu
崔	ymo
臭	jpeor
苑	fbu
捷	gju
摘	ghiu
吵	kvio
辩	nsre
魏	cmo
咐	kjeir
慎	hhor
昆	wme
誓	msr
凑	wle
袁	njou
撤	gxi
劈	bsu
蛮	pbi
卿	pjue
歇	wkor
添	nfi
牲	cg
售	mki
祭	ysee
纤	xnoe
咖	ktu
脖	hbu
沃	nfoe
廊	aju
租	cbi
撑	gcoee
岗	ysor
嚷	kbiu
肖	chi
旺	wsee
坊	lmr
哎	kfor
拨	gxu
酷	tjo
乏	jkr
稀	cheo
烤	pfeu
佣	jtou
踢	zwo
碍	dq
宅	vjeu
祸	hkiu
啡	kzie
跨	zke
坛	lme
凄	wju
综	xve
眸	bco
谅	slre
虹	blei
渊	nnro
愉	hqiu
刃	sjrr
械	tkeo
催	jyo
鞭	qje
邀	dmo
届	zai
肠	hto
兼	yro
洒	ntei
娶	yfuo
绳	xki
鼠	toi
墓	ylei
巾	yiu
哲	mkiu
耗	dwo
赐	dwou
胁	hwor
婉	mvo
遮	dnru
窝	dkiu
夸	kyuu
逢	nxr
泄	nduu
砍	daou
摔	gbuu
蝶	bdu
矛	hur
龄	hqor
屁	zme
岭	yqor
韵	mkr
夕	bour
媒	mdei
卑	doiu
愚	wlrur
湘	nvei
驶	ako
歉	yaou
疏	thre
咽	kqi
丘	qoi
矣	cvo
叛	jaur
巫	lforo
兹	apuur
蜜	vloi
娅	msei
饶	ppeu
狄	pproo
漆	ntor
腐	ajei
辣	nze
笨	lte
奸	mnee
嫌	myr
僵	jjiu
逻	cbr
吊	kyi
脾	hdoi
仓	dgu
舟	poo
胶	hqorr
囊	bhee
逆	srr
寓	vwiu
挖	gduuu
宴	vwu
刷	zyi
孝	fsui
乾	xvu
肌	haouu
捏	gwei
屠	zfe
患	kvr
尉	zse
驰	adu
翁	cyu
闯	fau
滋	nau
贪	qd
骇	ahr
纱	xvi
泡	nkue
迁	nrru
鹤	qmou
芙	fjee
耻	yhie
邮	ayui
饱	pkue
捧	glee
裙	hciu
叉	fjr
黛	bxi
搂	gqu
煞	xnrr
哩	kgiu
循	fae
筋	lhuo
砸	dvi
廉	ayr
陛	ymei
档	tcu
盒	cciu
艰	fhu
剪	asuo
债	jxi
役	fdou
绵	xdiu
膝	htor
抑	gpui
畏	gjuo
棒	tlee
呈	ksee
厦	adiu
吩	ksor
渴	nwou
嘲	kxo
绩	xxi
励	awuo
灌	nfiu
乳	ysu
爪	yooi
杖	tdr
蠢	lwiu
盼	bso
籍	lde
妥	ymu
卜	lir
舅	tgu
颊	wde
敦	gsoe
喉	kjue
苗	fg
咳	khr
栏	tae
帘	dyiu
颈	pne
拓	gdeo
汪	nsee
秒	cvi
瞒	bfe
杆	tnee
宙	vai
览	lfiu
寨	hteior
契	xse
掏	gko
址	lhie
翰	xdur
彭	awo
毅	hhouu
惟	hmo
稿	cgi
棉	tdiui
潘	nmi
妨	mmr
漏	nzei
纠	xbu
谨	syei
柴	tteior
琼	slrei
珊	ssou
乙	pu
裹	bwe
宠	vleo
塑	shei
盆	sciu
殷	acu
崖	yaei
署	cf
枯	tve
狮	pnei
霄	pciue
纽	xau
枚	tno
莹	wsr
巷	pgue
剂	nniiii
戚	kli
遂	whr
挽	gwou
哑	ksei
瑶	syoe
涨	nxoe
贡	ldiu
筹	lxe
册	sse
晋	swi
衬	hjei
斥	qjrr
魄	dso
腔	hde
陌	yjo
牺	ct
阅	fko
婴	dduo
蔡	fyee
芝	fkru
艘	pti
雀	cmoi
氛	vsor
鉴	lvor
粒	qhr
甩	hpuuu
腕	hvo
绘	xde
姚	mxr
撕	ggoo
藤	fhr
胞	hkue
咕	kvei
昭	wsi
谎	sfr
婷	mge
辨	nnre
糖	qau
贞	ldiuo
棍	tweu
倘	jciu
谦	syr
魅	sdee
麟	mqo
逊	scr
骄	afoi
歪	hkei
诡	shu
伪	jjo
蓉	fdor
鼎	bki
蓬	fne
钉	vaei
郡	cku
妃	mgue
薛	fji
冻	wyi
骤	ayur
沾	nti
塘	lau
斤	qoo
馨	lzo
叠	ffr
赴	mli
疆	xlei
伐	jkeu
眠	bq
禅	hhro
渔	ndo
赋	djeu
慨	hteu
削	chii
辽	cr
赚	dyr
拐	gkuo
澳	nzr
哇	khe
揭	gwouo
鑫	vvor
偿	jcru
倦	jlu
玫	snoe
竭	hwouo
枕	tqou
雁	ajoir
菊	dqr
耍	ymuo
倩	jhee
烛	pbiu
昔	pwi
泣	nhr
遵	djru
胳	hzou
谊	svi
辅	yfei
叙	qtu
绣	xcu
涯	nae
鹿	mreo
噢	kzr
俏	jciue
寇	vlie
摊	gfoi
翅	pfur
症	lke
瞥	qniu
宛	vbu
呜	kku
逗	hrrur
糕	qkr
畅	wjuo
趋	mxou
朴	tli
泼	nxu
账	dboe
俯	jaoi
逝	mrru
葬	fbo
讽	sao
祈	hqoo
衰	gjou
樱	tdiuo
拆	mjr
妄	xmu
饼	paeo
筒	lse
豹	dkrr
揉	ghei
蓄	fbuu
趟	mci
诊	sdooo
押	gaiu
镖	vte
嗓	kfur
绑	xxui
淋	nme
愕	hhee
倚	jkei
蜂	bnee
滨	nvoi
寞	vyei
裸	hwe
尹	cue
弦	xbuu
坑	lbou
滩	nfoi
儒	jpeoi
谱	sai
骚	afri
朕	haeo
胎	hciue
淫	nyo
竖	mhr
蒋	fzou
恍	hhir
哄	kpeii
鄙	kpiu
嫩	mzo
舱	pdu
践	zkee
劣	vwuo
萍	yher
遣	lhr
佐	jdei
荆	fnii
祷	hxe
壶	bji
麽	yju
膊	hfei
煤	pde
冤	qwo
兮	fweu
寡	vdiue
斑	sneei
窜	dkiue
颠	hfeo
拱	gpe
坠	ydei
搁	gfou
茨	fpr
惶	hdee
磁	dauu
妆	zmu
暮	ywiu
拂	gxo
匠	vqoo
怡	hciuee
晰	wto
峡	ywo
焉	kqrr
杭	tbo
旨	nwiue
轿	yfoi
瑰	ssoi
顽	lneo
瞎	bve
猴	pjueo
兆	xnreo
躬	zxu
裕	hfor
踩	zye
盐	lliu
填	lho
轴	yai
夷	kxu
斧	lqo
涵	ncr
哟	kxou
屑	zci
晌	wzi
帆	yar
刮	nniiii
篷	lnee
攀	tho
坤	lwii
怯	hwei
谭	sti
腊	hpiu
厢	ave
钦	vao
铭	vbiu
宰	vnr
篮	lliui
陀	yvou
仑	aor
兔	wxrr
烁	ppio
匪	vzi
桐	tsei
剥	cnii
堵	lfei
俞	qhii
棵	twei
贱	dkee
妒	mtr
框	tvee
眯	bqr
肆	bsue
靖	hheei
诞	sji
赔	dhiu
浸	ncru
蹲	zde
裳	cjr
惩	fkrur
钩	vku
吁	kaee
诀	svo
梳	txo
聂	yfuru
钥	vhou
浙	nmei
搏	gfei
雇	tmo
诧	svoe
灿	pyi
浦	nfei
窃	dnu
嫣	mkue
鲍	dkue
衷	bvo
丸	gjr
泊	ndoi
陡	ymeie
桶	ttu
躁	zki
蓦	yau
胃	ghiue
咯	kzo
姻	mqi
砰	dhe
崩	yho
耿	ypr
钧	vkr
茂	fkeo
恕	mkru
佑	jdiu
抄	gvi
隶	cnir
罕	qfe
凛	wbi
驳	aho
茵	fqiu
匙	snou
萝	wbou
凰	ade
岚	yaorr
亨	gcui
桩	taei
掀	maou
侄	jgeu
斋	nyeo
贷	bdi
畜	bpi
侦	jliu
哨	kciu
憾	hkeiu
庸	asi
恳	hlr
栗	tteior
啪	kgo
尴	xliu
绅	xwi
弘	xcur
携	gmu
履	zfo
挪	gsuiii
狭	pwor
轨	ygou
茅	fhur
坟	lnre
嘶	kgoo
赠	dwr
叮	kaei
撇	gqoe
龟	dwuu
芸	fmee
後	fpo
撼	gkei
拢	gleo
汝	nmu
倏	jneor
霉	pvu
溢	naor
靴	qyo
壳	bao
尬	xdo
笛	lai
悍	hwee
乞	vpu
肿	hviue
葡	dfei
烫	ntoo
宪	vgo
肢	hpur
嘱	kzoi
隙	yciu
啥	kqe
翎	qyur
忖	hjeir
碑	ddoi
裴	zjr
浆	zbiu
艇	psu
娱	mkee
擒	gdr
犬	peo
斌	njeu
羡	kpr
窄	dzoe
拘	gkiuee
沐	nteio
盲	xbiu
旭	gwi
郊	qhu
垫	dleie
栽	qte
捐	gkiuee
磊	dde
哗	kyei
芦	ftr
辜	vnre
茜	ftei
锡	vwou
秃	cao
脂	hni
棠	cte
酬	twr
侮	jvuu
媳	mjru
咧	kbii
鸭	afou
毯	wpr
坎	laou
涩	nsri
淮	nmo
歹	beo
骆	az
饥	paou
膛	hcei
溃	nliu
楞	tcr
丐	jluu
券	lsuo
逛	psru
煌	pdee
潭	ntiu
棚	thou
黯	xmr
膜	hyei
沧	nduuu
堤	lsi
颖	nce
栈	tkee
耽	yqou
噬	kleieo
掷	gaeo
卒	bfei
衍	fnee
蔽	fqo
堕	ydiue
绒	xkeo
栋	tyi
逍	chr
绸	xsei
涅	nwei
呐	kliu
绮	xkei
砖	dyur
蹄	zhiu
粘	qti
魁	swei
鸦	afour
棺	tvi
狡	pqor
妓	mpu
昧	wdee
萄	dyo
呻	kwii
盔	dpi
亩	bgi
腻	hkee
厮	ago
兜	dpu
孕	wsu
敞	csiu
搅	gniu
囚	kdor
脊	ndiu
驼	avo
巍	ycuo
鹅	wfo
缕	xqu
滞	nfr
矢	voe
锤	vzo
瞄	bfi
痒	lkro
塌	lwur
辟	bue
妾	hmu
汹	nhu
徽	aduu
嘟	kfui
擅	gbi
阎	fdoi
苹	fher
株	tjee
榜	threu
盏	kciui
敛	qmoe
廖	ayo
咪	kqro
妞	mau
掘	gzui
汁	npei
娟	mkiue
澡	nki
罐	yfi
勋	kdu
彦	haoo
焕	pdiue
呃	kauu
蕴	fxi
耕	dye
俺	jkiue
荪	fsi
灼	pkr
冉	sleie
扁	tliu
喧	kveiu
摧	gyoi
蒸	fcu
诈	szo
杏	tkiu
碌	dci
殖	bhei
嵌	ydou
捡	gqr
邱	qyui
姥	mfou
郝	cyui
璇	sdu
辕	ynou
厄	agu
绽	xpr
胀	hboe
苟	dkiuee
朽	tweuu
蜀	ckiue
彬	mwo
喻	kqiu
肺	hjiui
钓	vkrr
纺	xmre
峻	yco
坪	lhe
渠	nvue
窥	djiu
蜡	bpiu
咦	kkue
霆	psur
瑜	sqiu
缚	xfei
硕	dneo
枉	tseei
睹	bfeie
嫉	mlo
熙	qgr
雯	pnr
肝	hnee
蛛	bjee
瓷	pje
粹	qbo
尧	peu
渺	nbio
暇	wqu
冈	shor
绞	xqo
稽	cxro
贩	daur
溅	ndee
喀	kvo
巢	wwe
胤	jpiu
琉	sx
絮	mkuu
蔑	wkr
瞳	bhiu
斐	znr
禀	bxe
俘	jyu
凳	yhou
迭	jjru
焚	mpr
泳	njuu
衔	fve
梨	cne
墅	gheie
铸	vxe
潇	nfue
伺	jtei
吱	kpu
邵	skui
嘎	kdiu
祁	hyu
腥	hwoe
狸	pgiu
傍	jhre
滔	nyoi
疫	ldou
惭	hyoo
畔	gjro
樊	thor
帖	yti
阮	ylee
琦	skeiu
唔	kji
莽	fpeo
谣	syoee
淘	nko
蒲	yfeiu
吏	lhor
沫	ndeei
煮	fnr
敖	kee
驴	atr
熬	knrr
晒	wtei
捂	gji
幢	yhiu
陋	yforu
勿	jou
蹈	zyo
於	mdr
菱	flo
拚	gce
翩	tlu
婢	mdoi
虏	dwuo
澄	nyei
乍	zoei
沸	nxoi
嗡	kcur
啼	khi
喔	kze
襟	hme
孽	fjiu
叱	kneu
炭	ydr
趴	zfor
螺	bgu
窟	dzu
垒	ccur
卸	vhui
捣	gfiu
砂	dvio
歧	hpurr
麒	mgei
蚀	pbiue
侣	jkiuee
绷	xhou
渗	nco
澜	nfeiu
藉	fdei
莺	wfou
淹	nkiu
薪	fhei
毙	mbou
僻	jbue
髅	mqu
叨	ksuo
詹	hfre
迦	trr
荐	fdui
骷	mvei
捆	gkeio
嗦	kbuu
瞅	bcro
鳞	dqo
擎	dkoeo
嗤	kyeiu
衙	fjiue
菌	fkoe
聘	yaeu
膏	gkiuee
遁	apiu
荫	fyou
咙	kleo
嚣	hniu
朦	hweeo
憎	hwro
吨	kbeu
删	ssei
寝	vzu
彷	fmre
圾	lsou
旷	war
垃	lhre
稚	cmoir
夭	foe
鞠	qkro
磕	dwiu
捞	gwuoo
梭	tcor
稻	cyo
蚁	bnro
虞	dkeeo
蹦	zyou
秩	cjee
哉	qkiu
醋	tpiu
颂	cneo
尿	zniu
伞	dwe
胧	hleo
挫	gfeie
伽	jtuo
兀	jxou
梵	mar
凸	hieiu
弩	cxu
芷	fhie
禽	dqi
炽	pko
屯	beu
翘	pyur
宵	vciu
诵	stu
彤	sbo
雍	bpo
虐	dce
炒	pvio
氧	vkro
逮	cnr
挟	gwor
菩	fhiu
匕	nou
猿	pno
喇	kzii
踱	zdu
噗	kjro
溶	ndor
舜	ybe
奢	kfei
袜	hdeei
熄	pjr
啤	kdoi
橡	twou
嘘	kdii
弧	xyo
镶	vbiue
嗅	kjeo
嗔	khorr
禄	hcir
梧	tji
顷	nneo
缆	xliuo
蓓	phi
榻	twur
槐	tsoi
妍	mneeo
谐	smo
眶	bvee
挠	gpeu
敷	fmo
倡	jwiue
忿	slru
揪	gcr
蝉	bhr
屡	zqu
饺	pqorr
呕	kme
龚	lpe
茹	fmi
蝎	bwo
缎	xgo
讥	saou
蔓	fwiu
奎	khei
狞	pvei
揽	gliu
珑	sleo
霎	phuo
暑	wfe
婿	mmiu
哮	kfuie
嗽	kzou
铠	vyu
眩	bbu
钞	vvio
匀	kwre
嘀	khiu
襄	bheei
蝴	bvou
珂	sgei
阀	fjeu
锻	vgoi
嚼	kyiu
颓	cae
眷	lbiu
岔	syi
廓	agui
倪	jtouu
卦	hlirr
譬	bsr
绰	xliue
诅	sbi
谜	sqr
狈	pdiuo
咏	kjuu
陕	ywor
肘	hjeirr
梢	tci
诛	sjee
琐	sciuo
侨	jfoi
昊	wfee
淳	ngu
桓	tjiu
旬	kwiu
揍	gleeo
扳	gaur
熏	nxi
咸	kleiu
栅	tsi
纲	xsor
旱	wnee
嗜	kfou
掐	gdoie
舔	nfir
瓣	nyr
棕	tveei
鸽	cfo
燥	pki
噪	kkiuei
鞍	qvu
滥	nliui
憋	qnr
氓	xque
咆	kkueu
桢	tliuo
窘	dciu
簇	ldoe
涡	nkiuo
蕊	flru
霓	pto
箫	lsoi
拧	gve
彪	daoo
凹	hiu
伶	jqo
铅	vaiu
珀	sdoi
婶	mviu
叩	kwui
嚎	kgeo
骏	aco
鞘	qc
拙	gyui
拽	gwuooo
苔	fci
跋	zdur
沌	nbe
搓	gkeie
瘫	lfoi
沛	nji
湛	nguu
琢	shrr
喽	kqu
楠	tpiur
抿	gque
坝	ldiuor
咚	knrrr
壤	lbiue
晖	wqeu
槽	tjiue
窍	dleu
娥	mwoe
诃	sgeiu
撩	gkr
裘	wjr
祺	hge
卵	pjou
皓	djoe
沼	nsi
芽	faeu
橱	taeiu
拭	gkeiee
猾	pmi
甸	kgiue
沁	nlru
哆	kbou
笙	lgo
札	tpuu
缪	xyor
炯	psiu
戳	ymeu
粥	xqueu
佟	jnrr
戮	ydoo
剖	hkii
奕	pke
缸	yleie
悯	hfreo
豁	vxiue
栖	tteiu
禹	jkiui
斟	gpr
揣	gyeoi
懊	hzr
沮	nbiu
迸	anr
葫	fvo
扛	gleie
闺	fheie
怅	hboeu
缀	xfu
邹	xyuii
丞	cnee
冀	zge
瞟	bt
褐	hwouor
戟	xkeu
峨	ywoe
嬷	myo
犀	znoe
寥	vyo
酿	tju
碟	ddue
慷	haue
猩	pwoe
疚	lto
昼	kqiue
淌	nciu
棘	qqe
咨	pkiu
酱	zbei
冶	wci
绢	xkiu
阱	yyee
脯	hfeiu
滤	ndru
惫	ngr
浇	npeu
疤	lguie
钮	vau
萌	fwou
茱	fjeei
臀	zpou
缴	xdr
虔	dnre
葱	fjrr
瑾	syeii
杉	twoo
霖	pme
懈	hhuo
菁	fhee
圳	lwoi
觅	yfiu
沦	naoro
丙	fdorr
蕙	fjiuee
觑	djiuo
蝇	bkiu
泻	nque
蜘	bvi
虾	bleir
瞻	bho
萱	fvei
藻	ykiu
庵	akiu
匣	vaiue
叭	kforr
煎	anrr
焊	pwee
敝	qno
佬	jfou
蛟	bqo
挚	dnoe
檐	thorr
庐	atru
谬	syor
绯	xzi
烘	ppei
搀	gwour
辫	nxre
蹙	klio
牡	cleie
唾	kzoe
舆	tyeo
筷	lhue
樵	tmrr
蔬	fti
唬	kdou
逞	ksr
炫	pbu
弊	qne
忒	klru
酥	tcoe
拣	gyuo
钰	vsrr
簿	lnei
漾	nkru
噜	kdiue
啧	kxiu
踉	zju
茄	ftu
浏	nniiii
牟	cco
罡	ckei
剔	wjiiii
跄	zduu
舵	pvo
吭	kbouu
浊	nbiue
澈	nxiu
哧	kce
慑	hyur
铲	vheo
膨	haooo
垮	lkee
兑	kxouu
芮	fliu
仕	jlei
霹	pbue
韧	jsr
崎	ykei
芯	flrur
拎	gqor
撰	ggue
枢	tmeo
匿	vfeo
蝠	bli
叟	tjur
渣	ntiue
绫	xlo
颅	lze
颁	sneoi
祀	hgue
楣	tzi
竿	lneei
逾	qhiir
腮	hgr
厥	aso
枣	qwrr
黝	xpuo
窒	dgeu
聋	ly
蔚	fze
嗨	kno
拇	gvuu
砚	dfi
僚	jkro
闸	fai
芭	fgu
蛊	bci
锈	vcuo
惕	hwouoo
讪	syiu
瘤	lpi
晤	wjiu
蛙	bheie
驭	afur
璧	bsrr
辖	yvee
阙	fsou
媛	mye
雳	pauoo
侃	jko
邸	mju
巳	gueu
怠	ckru
锣	vcou
矫	vfo
驯	awoi
讳	sjeeu
蔷	fpro
灶	ple
搔	gfr
呸	khee
兢	vxei
鬓	bvoi
肋	hwuo
诏	ssi
镯	vcoui
娴	mfei
髓	mdeie
橘	thiu
棱	tlor
擂	gpiue
姗	msiu
帜	ykor
蹬	zyei
跺	zaei
琛	sqor
筝	lbouu
懦	hpeo
翡	zyur
婪	mmu
瘾	lyo
赎	dpur
巩	larr
钗	vfr
蚕	fbi
晏	wvu
刁	tjeee
庇	ameu
篱	lqiu
漓	nqi
庚	acor
轧	ypuu
蚂	bau
邢	nyui
锥	vmoi
熔	pdor
叁	cpe
嬉	mai
茗	fbiu
驿	afee
帧	yliu
瀑	nweii
窑	dyoe
偎	jgeuo
檀	tbi
寰	vce
骸	mhre
铝	vkiue
饲	pte
铮	vbo
辐	yliue
蔼	fsiu
秉	ccue
钝	vbe
徊	fxiu
阐	fhro
惘	hsr
酋	dro
捶	gzoe
瑛	sfi
凿	jku
甄	tleu
弛	xduiu
噩	skiue
洽	ncor
渝	nqiu
蟹	hsoe
窦	dpurr
捅	gtu
倭	jcuo
拴	gdeei
扒	gfor
砌	dnuo
咋	kzoei
玑	saouu
悼	hliu
穹	dx
萎	fcuo
涕	nxro
绊	xjro
蚊	bnreo
踹	zyeo
峭	yciue
笃	lauu
稣	dco
秽	cyou
贬	djrur
徘	fzi
遏	wkoru
睫	bju
癌	lkiu
禾	coei
揖	gkeii
潢	npiu
纬	xjee
碳	dyeo
溺	nxrer
哝	klruo
榆	tqiu
彰	mpo
蹭	zwr
歆	maouo
悴	hbor
厕	adii
璐	szou
拯	gcuo
癫	lhore
酌	tkrr
惚	hjru
睬	byei
瀚	nxor
驹	akiue
狰	pbou
庶	dnrr
竺	lye
眺	bxr
墟	ldii
屉	zduuu
褪	hhru
穗	cji
赦	cnoeor
瑚	svou
歼	bnoe
颐	qneo
啃	khiue
醇	tgui
憔	hmr
滕	hlire
忏	hno
雏	xmoi
泵	dniu
呛	kduu
谴	sliu
颔	qkeo
唧	ktui
皂	dneu
缄	xkeiu
柬	zwrr
曙	wce
喳	ktiu
椒	tlio
叽	kaou
踌	zxe
祟	yseei
祠	hteiu
肮	hbou
鹃	khou
朔	shou
晦	wvuu
悸	hcu
靡	yzi
炳	pfo
鸾	pfou
袱	hjeo
怦	hher
娄	qmu
氨	vvuo
硫	dxo
睿	lqe
曳	wpo
嗳	kyeo
衅	jcro
唠	kwuo
倔	jzu
褂	hhirr
匈	khu
勘	gpuo
傀	jsoi
锯	vzei
躇	zfei
剿	wwei
蟒	bfeo
缉	xkeii
玮	sjeeui
妲	mqiu
俭	jqr
粪	qpe
髦	bwoe
馈	pli
贮	dve
镑	vhr
岑	yqorr
惮	hhroi
簧	lpiu
缰	xjiu
侥	jpeu
涤	nneio
贿	ddiu
谍	sdue
浣	nvee
淇	ngeii
攒	ggoe
藩	ymi
赁	jsiu
雌	tmoi
沪	ntr
拌	gjroe
巅	yhor
榴	tpiue
梗	tbe
袅	fjre
芊	fnoei
腺	hdiuo
狙	pbiuee
讼	sco
漩	nduie
抒	ghur
啜	kfuru
笠	lhrer
嘈	kjiu
杠	tlei
蕉	fmrr
剃	xnii
褚	hfeie
茉	fdee
俐	jcii
奠	dkeo
茎	fpure
绛	xneu
熠	pyoi
苇	fjeeu
峙	yleir
阑	fzr
磷	dqou
肾	mhi
儡	jgiue
冗	qao
恬	hnoe
妩	mje
毋	vuu
哽	kbei
厘	agi
蝙	bti
膳	hkro
濑	nzoui
墩	lguieo
稼	cve
曦	wkoe
恃	hleir
婕	mjue
苛	fge
汀	naei
窖	djoei
辙	yxi
烙	pzou
诫	skeoi
筠	llou
惆	hse
炕	pbouu
溯	nso
镰	var
咄	kyui
琵	sseu
磅	dhr
炙	bpro
洼	nhe
邑	kguie
玖	sto
涟	nyru
疮	ldu
帷	ymoi
萦	wdu
毡	wti
摹	ynoe
炬	pvue
猝	pbor
桨	zbeio
坂	laur
募	ywuo
筛	lneiu
飙	ppeo
缅	xhe
涧	nfiue
恺	hyue
戎	kdeo
鹫	lxr
睦	blo
茸	fyeiie
枭	fteio
鸳	bgo
殆	bciu
奚	ypeo
笺	lkeeu
酣	tde
诬	slo
嵩	ygi
奄	kwuu
韶	msiue
闽	fbiue
悚	hze
瑕	squ
谕	sqiue
俨	jsoo
袄	hfoe
亢	baou
惋	hvou
氯	vcir
匡	vsee
糙	qjru
屿	yqe
靓	hfiu
嗖	ktiur
淀	nprr
憨	tyoe
聆	yqorru
坞	lku
粤	zqe
璋	smei
槛	tliui
鬟	bce
屎	zqr
迄	vpru
畴	gxe
蚩	yji
漪	npeo
趾	zhie
骡	aguu
桔	tnei
芜	fjeo
葵	fyeeo
忡	hviuei
孜	snoeo
隧	ywe
陨	ykiuo
崭	yyo
勺	kjrr
羁	cqu
撮	gweii
抡	gaor
烹	gcrr
揩	gmo
圭	heie
筵	lji
嗒	kfore
掣	vyi
咎	nliue
搐	gbuur
侈	jbou
亵	bdo
腑	haor
隋	ydeie
橙	tyei
咀	kbiue
捻	gqru
瘟	lwiui
暧	wyeo
簌	lzou
苯	ftee
啰	kcou
吝	nkiue
闵	fnre
惺	hwoee
卉	pneo
鲸	dlre
掺	gcoo
睨	bto
髯	bse
漱	nzouo
嗣	klue
碱	dkei
拷	gfeu
恙	klrur
靳	qqo
澎	naoo
吠	kpeo
钳	vde
吆	kpuu
呱	kyo
肴	hdiue
缔	xhiu
蛾	bwoei
攘	gbiu
疙	lvu
矜	hqorru
拗	gpuoo
佯	jkroe
萤	wbiu
汰	nkrr
笋	lcue
馒	pwiu
迢	skru
冢	qhrr
琶	ssu
廿	deiie
沥	nauo
扼	gauu
宦	vqe
鸥	mfour
寅	vjiu
赘	kdiuo
蜷	blu
蒜	fsee
痰	lpr
髻	bnei
蹑	zyuru
璞	sjro
垢	lae
捺	gkee
圃	kfeiu
掳	gduo
镀	vdu
礁	dmr
卤	thorrr
箍	lge
槟	tvo
羹	knro
讷	sliuo
裔	jsori
鸠	gfour
芹	fqoo
桦	tyeii
畸	gkeiu
遐	qrru
薰	fniu
霏	pzi
琅	sju
冕	wwou
钵	vtee
馅	pdoi
磋	dkeie
涣	ndiue
缭	xkro
渎	npur
贰	kyiuo
渥	nzeu
翟	ymoir
拈	gtie
鸯	skou
褥	hyeir
祯	hliuo
栓	tdee
荔	fwuou
筐	lvee
瘪	ljo
焱	pproor
乒	qjo
涎	njie
沅	nlee
埔	lfeiu
噎	kbeiu
烯	pheo
榕	tdor
粟	tqro
菇	fmei
昵	wzo
恤	hjiuii
啄	khrr
韬	jyoi
阜	jheii
孚	ysui
桅	thu
炀	ptoo
荧	wpro
殴	mdou
暄	wve
埠	ljiu
鹊	pwou
诣	sni
惦	haie
蠕	bpe
椎	tmoir
绥	xyuo
跷	zpeu
衲	hliuor
黏	cdir
傩	jfoir
癖	lbue
靶	qgu
矗	hhei
陇	yleo
锭	vprr
胥	mhiu
渍	nxiuo
崽	ygr
嚓	kvou
汲	nsou
叼	kteee
锄	vbuo
囔	kbiuei
羔	knrrrr
莞	fvee
吮	kcouu
绎	xfee
亥	hreu
狩	pveir
煽	ptur
炊	paouo
锚	vfiu
蹋	zwu
壑	lqeo
剌	znii
薯	wfei
昕	wqo
岱	byi
阈	fkiu
挛	pnoe
鲤	dgiu
萃	fbor
鹦	dduoe
茧	fbiuei
懿	bhre
恻	hdii
岐	ypur
谛	shiu
浚	ncoro
凋	wsei
甥	gguo
楷	tmoiu
绚	xkiue
瞩	bzo
窿	dyou
秤	cher
殃	bseo
癸	yfee
隅	ywiui
铎	vfee
钊	vni
恂	hkiue
啐	kbor
铨	vdee
鄂	hyuu
佘	dsee
舶	pdoiu
胺	hvuo
瘩	lfore
娼	mwiu
晁	wxre
锵	vzou
貂	dsi
肇	tnu
喏	kfeo
殉	bkiue
酶	tvuu
飕	ahoi
泌	nloo
憧	hhiu
赃	dae
炖	pbeu
垄	llei
柿	tbiu
玺	asr
胭	hqiue
扉	tzie
筱	ljoe
甭	htou
铐	vfeu
谑	sdeu
鹭	zzo
佰	jjoi
籁	lzoui
芠	fnreo
瓢	tsoo
汕	nyiu
梓	tnre
伫	jvee
鲨	nvou
瞿	bboi
眈	bqou
孰	gsou
驮	akeor
漉	nmr
幡	ymiu
壕	lgeo
稷	cgo
蹿	zdi
攥	gliue
烽	pnee
飒	haorr
紊	nduur
渭	ngiu
幺	puu
撅	garo
侬	jlruo
枷	ttuo
寐	vkee
濮	njii
霭	psiue
痊	ldee
唰	kziu
麾	ywoee
嗟	kkeie
喋	kdue
臻	glo
殡	bvoie
栩	tyur
幌	ywir
乓	qjrrr
炜	pjee
馀	pqe
醺	tni
皙	tqoi
珏	ssrr
烬	pkrr
矶	daouu
痉	lpu
辗	yze
缨	xdiuo
氢	vpur
桀	bjei
嵋	yziu
迂	arru
舷	pbuu
堰	lviu
簪	lneu
虬	bpuu
砾	dpio
谤	shre
垣	ljiue
袒	hqiuee
邃	dweo
硅	dhei
垦	hleiee
锺	vniu
黔	xqor
煜	pwre
哺	kfeiue
戾	tpe
忐	llru
谒	swou
簸	lguo
峦	pyiu
犁	cnoee
攫	gbiue
戬	sweu
辄	yyuu
碾	dze
撵	gjeeo
饵	pyei
谏	szr
曝	wweii
厩	ateu
鹉	jkiei
馋	pwour
偌	jfeo
忑	llrur
酪	tzo
潺	nzui
惴	hyeo
芥	fdoii
癞	lzouiu
毓	vvr
泓	nxur
咔	klir
蛤	bcor
皎	dqor
邬	kteu
噤	kmee
匾	vtiu
蟾	bhor
盎	skiui
痹	lgiu
沂	nqoo
阖	fwiui
悻	hlro
褶	hyoi
盂	aci
琥	sdou
嗷	kkee
沽	nveii
榨	tdoe
偕	jmo
隘	yaori
棣	tcir
蜒	bjie
椭	tyeoi
硝	dciue
缤	xvoi
缥	xte
甬	tur
唆	kcor
麓	mmre
昱	whre
荀	dwiue
滢	nwee
瘸	ltiuo
纶	xaor
腆	haorrr
汛	npeii
煦	wkiu
屹	yvu
伎	jpur
仟	jno
踞	zze
蕃	fmiu
骥	azi
臊	hkiuei
帛	dyiui
筏	ljeu
瓮	cjeu
鳄	dhee
憬	hwre
咫	kkor
溟	nqiue
迳	prru
榄	tliuou
苞	dgue
稠	cse
椰	tyui
旌	dgoe
俟	jcoe
捎	gciu
骰	mdouu
迥	skrur
跛	zzu
幔	ywiuii
臾	tdorr
刨	kgii
惬	hve
舫	pmr
睑	bqrr
铿	vmei
骋	aaeu
隽	mwuo
曜	wyo
婊	mxouo
铛	vcue
掂	gaie
崆	ydeiee
赂	dzou
萼	fheeu
湃	nneee
黠	xnei
咻	kjeio
跤	zqo
冽	wbii
纨	xgr
唷	kxiue
惰	hdei
猖	pwiue
羿	yneoi
毗	gmeu
榭	tze
恣	plr
潦	nkro
腋	hboro
呗	kdiuor
褒	bjiu
淬	nbor
哒	kkr
蹊	zyuu
囱	znee
袂	hvor
胚	hheee
攸	jnoe
诲	svu
璜	spi
璀	syoi
峪	yfori
藕	fdiuee
婵	mhro
踝	zwe
盅	vciui
杳	twi
忱	hqou
翌	yhr
篆	laouo
燎	pkro
崛	yzu
濒	nhioo
钠	vliu
烨	pyeii
橄	tteii
笆	lguieu
滇	nho
缈	xbio
泾	npure
沓	nwiuee
扈	tkui
鳌	kdoui
睽	byee
仄	ado
逵	lfeie
禧	haiu
卯	pou
邯	dyui
霁	pnoi
贻	dciuee
珞	szour
坳	lpuo
猥	pgeu
杵	tvei
撂	ggou
钙	vjie
盹	bbe
淤	nmor
豚	hheo
锢	vkeii
蜿	bvour
酰	tgo
酝	tmee
圩	laee
帚	cqi
蜗	bkiuo
茬	fdeie
瞠	bcei
啬	paiu
瀛	nyuo
腼	hheoi
蜥	btoo
湄	nziu
啾	kcr
拄	gkre
亘	jqiu
羲	kceu
篓	lqu
坍	lsr
骼	mzou
蚤	fjiuei
珈	stuo
涮	nziui
慵	hauee
孺	speo
嫖	mte
踵	zniue
聿	sue
衾	qjre
蟆	byeii
皋	dkeii
卞	jleir
飓	aheu
翊	hyure
闩	fjeee
脓	hlru
镣	vkroi
箕	lgor
壹	bheiu
呷	kaiue
溉	nteu
胄	ahi
瑙	swoi
驸	ajeir
悖	hbui
馥	cwoe
捋	gyei
镕	vdo
娓	mzoe
磺	dpiu
苓	fqor
痪	ldiue
酉	teiu
懵	hwru
衮	qco
辘	ymr
夙	ab
粱	nsor
宸	vyeo
姣	mqor
汾	nsoru
嫡	mhiue
蘑	fyeo
暨	tniu
檬	twee
戊	keo
颌	cneoi
秧	cseo
璨	slou
渲	nveiu
饷	pziu
咂	kviu
丕	hjee
赣	mpou
晟	wku
掬	gkro
遽	dhru
螂	bjue
笈	lsour
柠	tveii
蛰	dbi
嚅	kpeoi
蜈	bkee
痞	lhiu
荤	wyeu
峒	ysei
咛	kveii
蟠	bmi
瞌	bwi
汩	nkee
瞑	bqi
熹	akrr
搪	gaue
囡	kmuo
飚	ahro
倌	jviu
恁	jsru
偃	jviue
臧	kkeiu
讹	syoio
玷	stie
戍	kjrrr
莓	fvu
蓟	fdii
跚	zsi
龛	cleo
俸	jlee
魇	apo
隼	mpei
酵	tfui
撬	gwoe
疵	ltie
疹	ldoo
泞	nveiii
颚	hyueo
蝗	bde
侏	jjeei
鼾	jgee
徨	fdeei
翱	dkeiu
荃	fdeeie
浒	nsoe
蘸	fto
臆	hmru
噙	kdr
嗫	kyur
螃	bhreu
胯	hkeeu
纫	xsr
瘴	lmei
潼	nhiu
膺	ajoire
磐	pdeo
嘤	kdiuor
啷	kjuee
劭	skuo
诽	szi
槌	tjiueu
抉	gvor
剁	atii
篝	lpiue
瞰	bte
怆	hdu
酯	tniue
堇	yeiie
噘	kar
蹩	qniue
蹂	zhe
馁	pyuo
弼	xjo
鞑	qkru
骁	apeu
蔗	fdr
樟	tmei
轶	yjee
绺	xnir
篡	lbe
汶	nnreo
葆	psiuee
涓	nkiuee
氮	vpro
谚	sheoo
蚣	bcoru
掰	nsoee
掖	gbor
蹒	zfeiu
靥	apeo
熨	zsei
憩	njru
亟	ckur
鬃	bveei
虱	pji
晾	wlrei
垛	laei
嫔	mvoi
鬈	bluu
嫦	mciu
捱	gaeie
绉	xxou
彝	aqu
刽	dmi
颦	hceo
嗬	kforei
糜	yqro
豺	dtei
舐	nmou
嬴	ymuoe
蕨	far
掸	ghro
鳖	qnou
羌	kpuuu
纣	xjeir
敕	znoeo
阉	fkiue
谄	sdoie
恸	hmuo
娣	mxro
鹄	jfour
艮	hue
嗥	kdeor
佃	jgiuei
嘭	kaoo
躏	zfr
喟	kgiuee
蚌	bxee
皖	dvee
娲	mkiuo
诩	syu
恪	hzour
蜕	bko
樽	tdei
腌	hkiuee
俾	jdoiu
娑	nvuo
坯	lhee
椿	tliue
藐	fdoiu
碴	dtiu
抠	gmeo
纂	lbeo
涔	nyor
酮	tseiu
诘	sneie
杞	tgue
昙	wmee
辊	yweu
芍	djrr
耘	dme
烷	pvee
郢	ksui
谩	swiu
褛	hqu
罔	sar
梆	txu
裟	nvre
濡	npeoi
饯	pkee
袈	tjre
怂	flrurr
谧	sloi
町	gaeii
莘	fnrer
芋	faee
嵇	cxri
匝	vyiu
舀	ytoi
宓	vloo
娉	mae
锌	vnrer
湍	nyeoi
鸵	fvou
涸	nkei
孵	pjour
沏	nnu
唏	kheo
吒	kjeu
龊	hkie
愫	hxu
噼	kbue
龌	hzeu
闰	fseei
橇	twoe
澹	nhor
徙	fhieo
耦	dwiui
褴	hliui
漳	nmeii
镂	vqu
氟	vxoi
擞	gquo
竣	hcoro
殇	bvu
痣	llrurr
谪	shiuo
脐	hnoi
犊	cpur
谙	smre
皑	dyue
渤	nbu
斫	dqoo
泗	nkou
蒿	fgi
掇	gfu
淆	nheo
颉	nneoi
釜	lnro
赈	dyeoe
耷	kyeii
睐	bwio
捍	gwee
佗	jvou
踊	ztu
茴	fxiui
睇	bxro
嚏	kbiuei
孢	skue
媲	mzor
荼	fqeio
窈	dpuo
柒	nneior
塾	gsour
颀	qneoi
逅	alru
榈	tfi
岖	ymeo
恿	tlru
赊	ddee
瘁	lbor
淄	nwiuei
佼	jqor
胫	hpure
泷	nleo
耙	dgui
禺	wli
岌	ysou
宕	vdeo
匍	kfeiue
隍	ydee
菠	yzuo
邂	hsoee
谟	syeiii
汴	njei
咿	kjueeo
粲	lbur
碘	daor
妪	mme
噫	kmr
谆	sgui
羚	kqorr
泯	nqueu
孀	mpeio
缜	xhor
怏	hseo
鳗	dwiuii
邝	ayuii
粼	qbe
烩	pdeeu
渚	nfeie
摒	gzr
婀	myei
骠	atee
獠	pkroi
闫	fpee
肪	hmre
翦	ayure
蜻	bheeie
戛	dbeu
僮	jhiu
颧	fhoi
赧	cwur
蠹	bdiu
藜	fco
湮	nteie
榛	tloe
娆	mpeu
锹	vcr
覃	tweii
蜴	bwou
鸨	npo
瓯	mjeu
挲	nvoee
揄	gqiu
巽	ggei
楔	txuo
壬	soe
涝	nwuo
赡	dhor
荟	fdeeu
愠	hwiu
啻	hyi
珉	sque
挹	gkui
踮	zaie
诌	sxo
绾	xviu
垠	lhuee
觞	hvuoo
谀	stor
臼	toie
呓	kfuu
濂	nar
阪	yaur
闾	fkiuee
皿	ciui
麝	mze
衢	fbiuee
濯	nyoir
殓	bqrro
镔	vvoi
郸	hyui
淼	nniu
镐	vgi
窕	dxr
昀	wkre
噶	kfi
贲	pfiuo
霈	pneiu
柑	tdeii
镌	vmu
钾	vaiuee
摺	gyoiu
挎	gkeeu
辍	yfurur
蜃	ybiu
蛆	bbi
菀	fvour
弈	pneoi
髭	btie
蜓	bsur
洱	nyeii
荻	fproo
骈	aaeo
羟	kpur
箩	lcou
辇	jjeu
惇	hguie
邋	wkorur
坷	lgei
啮	khie
腴	htorr
楫	tkeii
剐	klii
孪	psui
俪	jce
颍	nneoiu
啕	kkoe
雹	pkueu
霾	pdiuee
雉	vmoir
狒	pxue
匐	kliue
琨	sweuo
瘀	lmor
琏	syru
峥	ybou
哂	kteiu
铀	vaiuei
戌	kjee
迩	arrur
虻	bxre
瘠	lnor
旖	dkeiue
忸	haui
阂	fhre
籽	qsu
坨	lvou
蜚	zbiue
榔	tjue
粽	qvee
诙	sdr
搽	gfore
耆	fniue
骊	ace
辔	xyuu
琰	spro
晔	wyei
犷	par
赳	mbu
谗	swour
诠	sdeei
箴	lkei
酗	thui
菡	fcr
蔻	fveeo
弑	hteur
堑	yqei
浜	nqor
槁	tgi
怩	hzouu
咤	kvoe
佻	jxre
缇	xsiu
睾	jcei
垭	lsei
卅	jwoi
讫	svuu
斛	hweii
懋	theio
倜	jseie
斓	nfeiue
恫	hsei
迤	vdr
淞	ntoru
彗	xxue
仞	jsrr
琬	svour
喵	kfiu
胴	hseiu
篙	lgiue
噔	kyeiue
鲲	dweu
淅	ntooe
殒	bkiuor
嶙	yqour
鳅	dcr
痘	lhei
潍	nxoir
泠	nqorr
颏	hneo
遢	wyr
腓	hzi
洵	nkiuee
欤	qjou
邺	jyui
蟋	bmr
螳	bceie
饨	pbeui
摈	gvoi
峋	ykiue
沱	nvouu
谲	shiuor
诋	smrr
犄	ckeiu
泸	nlu
匮	vliuo
屐	zfeiur
呦	kpuo
柩	tvou
龇	htie
诮	sciue
翳	vvou
橹	tdiue
嗝	kleiue
盥	tniui
棹	tliuee
桧	tdeeu
忤	hvei
鹞	yyou
秆	cneei
鄱	mgui
蹇	hkieo
蟀	bbuu
蛀	bkr
剽	tsii
糗	qjeo
淙	nveei
饪	pso
绡	xciu
祗	hmrr
藓	fdro
岷	yqu
钹	vdur
钛	vkrrr
抨	gher
嵘	ywei
馍	pyeiii
婧	mhee
遑	dsr
俎	fbiuee
苷	fdeii
嘹	kkro
佞	jyuo
濠	ngeo
刍	xou
挝	gjru
骅	ayei
窠	dwei
咝	kpuue
臃	hbuu
糠	qaue
馄	pweu
斡	xdrr
绶	xyur
煲	jsro
蔺	ffoi
弁	cneoii
囗	kiu
滂	nhre
兖	qcou
鸪	vfou
聒	ynoei
箸	lfeieo
牒	kduei
跻	znoi
豌	hvour
觊	ygiu
牍	kpurr
栾	ptei
忻	hqooe
嗲	klo
诳	spee
俑	jtur
镁	vkeo
觎	qhiii
胰	hkueu
箔	lnoi
怵	htr
寮	vkroiu
喙	kaouo
劾	hwuoo
焙	phiu
滟	nxou
挞	gkru
妤	mhu
韭	zjeee
绦	xneio
猬	pgiue
灸	tpr
鸢	kfour
茁	fyui
潞	nzour
揶	gyuii
鹑	gsouru
磬	lzouu
氲	vwiui
岫	yaiu
蹶	zar
膘	htee
瑁	swiue
氅	csiue
鹧	dnou
酊	taeii
蜍	bqe
皈	daurr
汐	nbou
佚	jjeeo
馏	ppiu
銮	pvor
辎	ywiue
釉	maiu
玳	sjeu
旎	dzouu
叵	vkiuee
陂	yzuoi
裱	hxo
祛	hweie
嵬	ysoi
偻	jquo
漕	njiu
呶	kmur
鹳	fhoir
蚓	bxii
黍	cdire
顼	sneoiu
砧	dtie
弋	keur
咭	knei
娩	mwou
疡	ltoo
疟	lce
徇	fkiuee
徵	ase
饕	kwie
肛	hleiee
吡	kmeu
玟	snre
猷	dpeo
啶	kprr
唁	ksre
讴	smeo
孑	sui
姝	mjee
觐	yfiuo
裆	hcue
鹗	hyuo
鳝	dkro
鲈	dlu
骛	hnu
痨	lwuo
鹂	cfou
蠡	ahiu
畦	gheiee
汞	lniu
铰	vqor
钜	vvuee
胱	hhiro
悒	hkui
鳍	dfou
嘁	kkie
蟑	bme
秸	cnei
栉	tfuii
帏	yjeeu
嗑	kwiui
诰	sjoe
橐	bdei
箐	lheei
泱	nseo
媪	mwiui
俚	jgiuee
黜	xyuiii
潸	nmiu
柚	tai
恹	haeor
绔	xkee
囤	kbeui
螭	bqiu
獗	paro
狎	paiue
呲	ktie
稹	chor
嫫	myeii
韫	jwiui
熵	phiuo
搡	gfur
懑	nfeiuo
飨	pjor
靼	qqi
赭	cfe
豢	lheo
侗	jseiu
蚯	bqoi
纾	xhu
孱	zsu
驷	akou
畹	gvou
滓	nvrer
傥	jcou
骜	kauue
礴	dyei
畿	ppeuo
氤	vqi
掴	gkeei
俦	jxe
罹	choi
箝	lgeii
笞	lciu
砥	dmrr
倨	jze
轼	ykeie
缮	xkroe
酚	tsor
荏	psoe
琮	sve
椽	taou
夥	wtou
圜	kcei
钿	vgiu
砺	daeu
鲶	dqru
蛐	bai
爿	kui
浃	nwor
诿	scuo
祢	haoui
祚	hzoe
仃	jaei
钺	vkeu
轭	yauu
蓑	fgeo
葳	fkeu
眦	btiei
唑	kfeie
魑	sqiuu
阕	fyeeor
镫	vyeiu
荞	ffoii
痢	lcii
獭	pzoui
燧	pweo
溧	nteior
饬	pvuo
炷	pkre
庾	ato
镍	vjeio
遨	krrur
骞	hauu
遛	pgr
扪	gfri
裨	hdoiu
摞	gguu
嗄	kdiuee
铢	vjee
喁	kwiuie
鹘	mfouru
馔	pgueu
肽	hkrr
淖	nliuee
帼	ykee
婠	mviue
榷	tqoir
镳	vmr
豕	heou
碉	dsei
荚	fwor
溥	nfeir
咩	kkroe
僭	jneu
锉	vfei
酩	tbiue
蹴	zleo
胛	haiue
眇	bvio
庠	akro
灏	nwre
昶	jtuor
揿	gvouo
翕	cyur
罄	lzouur
嫚	mwiuii
趄	mbiu
醛	tfore
蛎	bae
糯	qpeo
溴	njeo
幄	yzeu
夯	kwuoo
傧	jvoi
锏	vfiue
铣	vgoe
桠	tseii
剜	vbuu
佥	qmr
谥	saor
矾	darr
忪	hcoru
檄	tdre
捌	gkuoi
鱿	dxrr
锰	vsi
钏	vwoi
哔	kmei
麋	mqr
肱	hdur
伧	jduu
烃	ppu
湎	nheoi
欹	kgou
摁	gqrur
庖	akue
鲑	dheie
赍	pfr
萋	fju
犒	cgiu
幂	qwe
饽	pbui
邈	ddou
螓	bloe
夔	ajie
闳	fdur
镭	vpi
泅	nkor
岬	yaiue
莅	phr
箬	lfeo
珩	sfeei
牝	cnou
扞	gnee
荑	fkue
鸷	dfour
嶂	ymeii
宥	vdiuee
靛	hpr
阡	ynoeii
邙	xyuiii
蝼	bqu
罅	ydor
涪	nhiue
拮	gnei
蘅	ffou
葶	fgei
玎	saeii
埂	lbei
棂	tcro
挈	xsoe
奁	kmeo
龈	hhue
鲫	dtu
踅	mkie
姮	mji
餮	bdoo
阒	fbe
鄢	kqrrr
逦	crr
诶	scoe
裾	hzei
罂	ddoe
粑	qgui
稔	cqr
珅	swii
痫	lfeio
燮	sproo
滦	npeio
撷	gneo
啖	kpro
厝	apiue
蛹	btu
绌	xyuiii
氰	vhee
楂	tti
咣	khir
陲	yzo
闱	fjeeui
莆	ffeiu
擢	gyoir
弭	xyei
邕	wkui
荥	wniu
灞	npeiie
偈	jwou
袤	bhou
煨	pgee
轲	ygei
蹰	zaeiu
诨	sqe
汨	nwiuee
擤	gjiu
凫	faouu
亓	jjeo
箧	lver
睥	bdoi
馊	ptiu
膻	hbiui
缙	xsiue
浔	ncei
殁	bdou
柘	tdeo
忝	fcir
勖	wbu
鹌	kwuou
锃	vkeei
褓	hjiue
瓒	sgo
塆	lpue
螫	cniu
峤	yfoii
铬	vzour
葩	fduie
纡	xae
槎	tkeie
岙	fyiu
姘	maeo
阗	fhor
衿	hqorru
纭	xme
殛	bciue
楮	tfe
枸	tkiue
刎	jnii
鲛	dqorr
躅	zco
蠊	bar
怄	hmeo
崴	ykeu
驽	cau
佝	jkiuee
襁	hxi
涿	nhrr
猢	pvou
楹	twuri
雠	msoi
铆	vpo
缢	xaori
睢	bmo
狷	pkiue
噻	kheie
璎	sdiu
铡	vdii
疽	lbiuee
瑭	saue
铄	vpio
蔫	fkuer
暝	wqi
喑	kmre
魍	ssro
蓼	fyor
甯	vliue
啭	kyee
杷	tguie
逡	cfour
苜	fbiuee
羸	ykro
嫒	myeo
伉	jbouu
邨	byu
笏	ljou
疣	lxrr
毂	byou
讣	slir
粕	qdo
蹉	zkei
跎	zvou
脍	hdeeu
揆	gyeeo
鳃	dgr
泫	nbuu
杓	tkrrr
杈	tfr
鳕	dpue
辂	yzou
诟	saeiu
蝌	bcrr
獐	pmei
桁	tfee
栎	tpio
栀	taeu
妊	msoe
隗	ysoiu
讵	svue
痔	lleir
珣	skiuee
梏	tjoe
撺	gdiu
苣	fvue
鏖	mvor
诓	svee
誊	lsre
抻	gwii
嘣	kyou
铵	vvuoe
舂	ltoi
骧	abi
钣	vaur
繇	yyouu
癣	ldro
瘘	lquo
榉	tmor
彀	bjueu
蕲	fhoo
崂	ywuoo
噌	kwro
锲	vxu
蚱	bzoe
牦	cwoee
煊	pveiu
暹	wmr
懔	hbiuiu
愆	fneei
醮	tmrrr
笳	ltuo
趔	mbii
诒	sciuee
褡	hfore
羯	kwou
猱	phei
娠	myeoe
鸶	ppeou
芩	fqorr
掮	gtiu
囿	kdiuee
儆	jfoui
侩	jdee
仝	dleiee
蛔	bxiu
耄	fnoee
琊	saui
恽	hqeu
姒	mbur
鸩	qx
醚	tqru
绻	xlu
忾	hvoe
碣	dwouo
獒	kpeor
桡	tpeu
掼	gviu
囵	kaor
芪	fmou
箓	lcir
牖	kteiue
濛	nweeo
澧	naeiu
鳏	dcio
菖	fwiue
苋	ffiu
蒺	floe
篑	lliuo
潋	nqr
汜	ngue
徕	fwio
孬	hmui
唳	kteo
酡	tvouu
遒	drru
踯	zaeo
苒	fsei
纰	xmeu
祉	hhie
砷	dwii
柢	tmrrrr
哐	kvee
腭	hheeu
鬣	bwiu
茛	fhue
瑗	syee
戕	kkeu
愎	hviuee
悌	hxro
呤	kqorru
铉	vbuur
轸	ydooo
觥	hhiroe
蚪	bwei
壅	bpoo
噱	kdeou
阚	fteii
铤	vsur
辚	yqoure
踽	zji
貉	dzour
谯	smrrr
佶	jnei
魈	sciuee
葭	fqu
瑷	syeou
焖	pfru
郜	jyuii
磔	dbeui
狲	psio
桎	tgeu
垩	sleiee
牯	cvei
沣	nxee
枇	tmeu
舸	pgei
腱	hsur
嫱	mpro
傣	jlir
伢	jaeu
舢	pyiui
姹	mvoe
魉	sfo
螯	kbiuei
薮	fquo
艄	pciuee
廪	abiu
蓁	floei
缱	xliueu
篁	ldeei
桉	tvuo
杼	thur
鸱	mjo
霰	ppiue
闼	fkrurr
逋	frr
蒯	fhou
鹜	hnou
颢	wleo
颛	ypeoi
锷	vheeu
钯	vgu
蚜	baeu
奂	dseo
哞	kcoe
贽	ddiuo
铳	vxou
臬	jteio
墉	laue
埭	lcire
讦	sneeii
蓿	fvor
硷	dqrr
畈	gaurr
崧	ytor
醴	taeiue
踟	zviu
赝	ajoire
秣	cde
犟	xkiuei
爰	yjeo
拊	gjei
僖	jaiue
谌	sguu
疱	lkue
嗵	ktr
乩	tpuuu
鲷	dseie
郦	cyuii
茏	fleo
磴	dyeiu
槿	tyeiie
娌	mgiu
妯	maiue
鳟	ddei
盱	baee
冼	wgo
郴	myu
炔	pvorr
唿	kjru
蜢	bsi
圻	lqoo
卟	klirr
魃	sdur
谡	sgor
俅	jwei
轾	ygeu
薜	fbue
莒	fkiuee
砒	dmeu
烊	pkroe
搦	gxre
齑	nnie
邳	hjui
螟	bqiue
徉	fkro
陟	yhio
钨	vkue
蛱	bwor
竽	laeei
枞	tforo
搴	hnoee
恚	hlrur
媾	mpi
谔	shee
蚝	bwoee
茯	ppeor
膑	hvoi
硼	dhou
擘	bnoee
撸	gdiue
悭	hmei
幛	ymeiii
鬻	xqueue
阆	fjue
螨	bfeiu
舛	bjeu
鳚	dzee
骓	amoi
锟	vwe
铂	vdoi
跖	zdeo
矍	bboir
邛	lyu
逖	ppru
葺	fkeii
苄	fjei
眙	bciuee
湫	ncro
鼹	twrr
癯	lbiuee
旃	dsre
垸	lveeo
诤	sbou
蛭	bge
殚	bhro
邡	myui
跆	zciu
莠	fcuoo
樾	tmeuu
囹	kqorru
啁	kseie
亳	gjeu
乜	tpuuuu
鼬	taiu
羧	kcoro
鄞	yyui
簟	ltiue
瞽	apur
猊	ptou
犸	pauu
奘	kleor
骢	azo
雒	zmo
铧	vyeii
缟	xgi
睚	baei
镞	vdoe
玥	shoue
槊	sheio
怫	hxoi
綦	gduur
搠	gsoue
寤	vkeiu
啵	knu
酆	yxe
狯	pdeeur
湟	ndeeie
徜	fciu
醪	tyor
衩	hfrr
柞	tzoe
抟	gyurr
俳	jzie
砭	djrurr
淦	nvor
唢	kciuo
呋	kjeeo
黧	ckoi
茔	wlei
樨	tzir
饴	pciuee
衽	hsoei
珪	sheie
猡	pco
猕	pxo
曷	wkoruu
轳	ylu
蜇	mbiue
缦	xwiu
畲	dsiu
墀	lzi
钤	vqorr
蕖	yveu
滘	nqore
仨	jpee
镛	vaue
戢	kyeu
囫	kjouo
荩	fkrr
疝	lyi
猗	pkei
洮	nxreo
尕	wcio
垟	lkroe
砦	tdeoi
椴	tgoi
麴	pdou
蜮	bkiuee
眬	bleo
痼	lkeii
痍	lkueu
疥	ldoi
聩	yliuo
焘	xjrr
滁	nyore
沆	nbouu
枰	ther
徼	fdre
侪	jnoi
锂	vgiue
逶	cmr
荠	fnoi
痂	ltuoi
怼	fjru
阍	fmiue
錾	yqore
薨	wqeo
缁	xwiue
祜	hveii
旄	dwoe
馗	gaoi
钴	vve
菏	ygeiu
嗪	kloe
遴	qbeu
诂	svei
竦	hzeiu
煅	pgo
樯	tpro
骝	apiuei
郗	hdiuiu
赉	wniuo
蝈	bkeei
薏	fmru
萸	ftor
菸	fmor
菟	fwour
莴	fkiuo
荦	wco
苕	fsiue
鹈	xfo
萘	fkee
碜	dcoo
瘢	lpo
晷	wnir
擀	gxor
鹬	hsor
钡	vdiuo
殄	bdooo
椁	tguiee
扃	tsiu
鞅	qse
镊	vyur
钎	vnoe
菅	fviu
肓	xhiue
砀	dto
墒	lhiue
嚯	kpo
珲	sqeu
沭	ntrr
刈	hnii
虢	yjie
膂	djiue
缛	xyeir
笄	lneeo
岘	yfiuou
骐	age
迨	ckrur
苫	ftie
穰	cbiu
旯	wgou
鹕	vhour
蚧	bdoii
矞	hsori
旮	gwiu
旆	djiui
屦	zfro
胪	hlue
罴	cwrr
砣	dvou
歙	cyouo
婺	hnuo
圄	kjiue
剡	ppii
鞣	qheio
蓣	fheo
荨	fce
洙	njeei
堞	ldue
勐	scuoo
骖	acoo
铙	vpeu
讧	sleiee
臌	haei
钲	vkeie
豸	dorr
訇	ksree
蚨	bjeeo
硐	dseiu
瑄	sveiu
沤	nmeo
帔	yzuoiu
垓	lhreu
蚋	bliu
爻	hhorr
渌	ncir
槭	tkie
阃	fkeio
酢	tzoei
薹	fnru
芘	fmeu
毵	cwoeeu
蛩	lari
莜	fjo
碛	dxi
夤	bvei
哚	kaeio
呔	kkrr
鲟	dcei
阊	fwiuee
谶	sfeie
藁	fgiu
稗	cdo
珥	syeiie
吲	kxii
颞	yfeo
镬	vfoi
嵯	ykeiee
驺	axo
镗	vcei
藿	fpoi
掾	gaouo
孛	bsui
嘬	kwei
鲇	dtiei
邰	ckui
襦	hpeoi
蕈	ftiu
苻	pjei
腈	hheeie
甾	wgi
晗	wqiu
垅	lleou
鼍	hgei
鼋	lkiue
訾	tsr
蜉	byui
蘩	fvuu
舄	tkrrrr
膈	hleiu
疸	lqiue
疋	mui
楸	tcroo
髋	mveii
郅	gyuiii
跹	znru
赅	dhre
蓍	ffoui
篦	lzor
窳	dyoo
呖	kauo
伥	jboe
鹚	apuuro
鸫	ycou
莼	fxe
筮	llor
珐	sweie
氐	mjrr
栊	tleo
杲	wteio
郧	kdui
纥	xvuu
屣	zfi
郄	hduru
赓	acori
脩	jniu
聃	yseie
碓	dmoi
疃	ghiuee
爨	tseiue
泮	njro
榫	tmeii
喱	kaiuee
傕	jqoi
锗	vfeie
郓	qyuii
蹼	zjro
狻	pcor
韪	sjeeui
锆	vjo
鎏	nxoiu
诎	syui
瓠	kyuo
涫	nviu
帙	yjeeo
嶷	ynoee
埚	lkiuo
鳐	dyoee
馐	pkui
豉	hpurrr
苎	fveee
痈	ltou
怛	hqiuee
啉	kmeio
卮	ajuu
仵	jvei
锜	vkeiue
邾	jdui
茕	wpeii
疠	lweuo
孳	apuuru
鸬	lzour
鲠	dbei
趱	mgoe
蘧	fdeo
萏	fdoie
硒	dteiu
珰	scue
獾	pfiue
仡	jvuuu
鼙	apuro
黩	xpur
谘	spiu
蠲	afiu
耋	fneu
碇	dprr
杪	tvio
徂	fbiuee
塍	hleiee
蝮	bviu
虺	jxiu
蕤	fhoe
菽	flio
耒	deee
檗	btei
橼	txuu
柰	tseeio
垆	llu
阄	fdiuee
跗	zjei
觯	hhroiu
菰	fsoo
艉	pzoe
缃	xvei
篾	lceo
瀣	nlou
扦	gnoeii
圉	klro
凼	nsui
麈	mkre
迓	arrurr
赀	tdiuor
翮	lyur
禳	hbiue
痤	lfeiee
甑	wjeu
愍	qnru
彧	kkeo
餍	apor
襞	bjre
縻	ydu
秾	clru
淝	nhui
氖	vwuoo
兕	hxou
锑	vxr
邗	nyuii
谵	shorr
裢	hyr
犍	csur
欷	hdiuio
晞	wheo
彘	ano
帻	yxiu
钒	varr
醍	tsiue
跸	zmei
漯	nguur
洄	nxiui
庑	ajeo
坼	lqrr
哓	kpeu
踬	zaeii
褊	htiu
腩	hpiur
脲	hziu
缬	xneo
纛	xviue
痿	lcuo
坩	ldei
圪	lvuu
嘧	kvru
麸	xneeo
隈	ygeuo
锱	vwiue
蠃	ybiue
蛉	bqor
蓖	fzor
糅	qheior
柙	taiue
昴	wpou
慝	vfeor
嬛	mce
鲱	dzi
锨	vqou
趺	zjeeo
荜	fmeii
艏	paoi
箜	ldeie
狺	psre
燠	pzr
汊	nfrr
戗	dgeuo
坻	lmrr
圮	lgue
儋	jho
龋	hjiuei
龃	hbiuee
飧	bpor
郯	ppui
詈	csr
缯	xwr
缗	xqi
筇	llui
瓤	bheeii
溷	nkeo
涞	nwio
堀	lzui
龅	hkueuu
骶	mmrr
锴	vmoiu
醐	tvoue
蘖	fjiueu
篌	lju
玕	sneeii
焯	pliu
枳	tko
昝	nliuee
悱	hzie
岿	ynu
嗐	kveee
龉	hjiuee
莪	fwoe
绂	xdurr
笥	ltei
祐	hdiuee
硌	dzouri
砝	dweie
燔	pmiu
湜	nsiu
洌	nbii
戆	mpour
徭	fyoe
哌	kaouor
偾	jpei
伛	jme
髂	mvou
隳	ydeieo
铩	vhei
荇	ffee
篪	laie
眄	bku
炆	pnre
棻	fseio
栲	tfeu
暾	wgu
黢	xco
鳉	dzoure
铋	vlooo
裎	hkeei
莳	fwei
芨	fsour
窨	dmre
瘿	ldiuor
渑	nkiuee
氦	vhre
橛	tar
樗	tpee
怙	hveiiu
侑	jdiue
蹚	zce
趿	zso
蝣	bdui
苴	fbiuee
脔	plo
纮	xdurrr
麂	maouu
鲀	dbeuiu
镝	vhiu
轱	ypi
觜	thouo
螅	bjrur
芗	fpoo
矽	dbou
矸	dnee
瞵	bqour
疖	lwui
玢	ssor
愀	hcro
髡	bjo
镒	vaor
貔	dzor
褫	haieu
缣	xyr
筲	lciue
椋	tlre
撄	gdiuo
崃	ywio
傈	jteior
黼	jqoe
陉	ypure
铱	vjr
醢	tdiuei
蹓	zpi
蓊	fcur
翥	ffeie
秭	cxrou
疴	lgeiu
槲	thrr
曩	wbiue
嘞	kquo
陬	yyur
趸	wkie
绀	xdei
稞	cwei
砑	daeui
檠	dkoeor
槃	pdei
桷	thouou
嵴	ynor
崮	ykeii
嬖	bmu
喆	nneie
雩	pyuu
钼	vbiuee
醯	txoi
胝	hmrrr
盍	wciu
璟	swr
溘	nwiui
枥	tauo
屌	zkiu
嬗	mbiui
垌	lseiu
坭	lzouuu
哙	kdee
倥	jdeie
髁	mwe
酹	tyeir
郏	wdui
贶	dkou
芫	flou
罍	ggiue
絷	dduu
絜	xsu
穑	cpro
祇	hmou
碚	dhiue
瘗	lwor
琚	sze
珙	spei
枋	tmre
帑	cyi
鳜	daro
飏	ahuo
酲	tkeei
觚	hyoou
砬	dhrer
皤	dmiu
犴	pneei
澍	naeir
歃	ntou
楝	tzr
摭	gdrr
尻	zgo
鲽	dduei
鬯	hnui
雎	bmoi
貅	djei
裥	hfiue
蝾	bweio
葑	fheir
箪	lhro
笤	lsiu
窣	dbor
皴	cfouru
毳	wwoe
廛	agor
鬲	leiu
髫	bsiu
逑	wrrur
蹀	zdue
诜	sgoe
謇	hsre
蠖	bfo
蝽	bliue
蚬	bfiu
腚	hprr
沔	nkuu
塬	laoi
黥	xlre
麇	mco
鲙	ddeeu
蚴	bpuo
缫	xwiuee
癔	lmru
溲	ntiur
刳	kyuii
鳎	dwur
鲭	dheei
髀	mdoiu
颡	ffeio
锒	vju
觇	tfiu
蘼	fyie
茭	fqorrr
肄	nvuee
禊	hxuo
炝	pduu
棰	tzoeie
旒	dxoi
垡	jkeie
喹	kkeiee
匏	kyuou
鼐	wbue
鹪	mno
鲧	dju
髌	mvoie
骀	aciu
颙	wleoi
鞫	qkre
菹	ybiuee
苡	fbur
芰	fpurr
祆	hfoeo
硖	dwor
獬	phuoo
柽	tfei
厍	ayeu
鲵	dtou
觌	ptrr
螈	baoi
蒡	fhreu
芡	faouo
胼	haeoi
糁	qcoo
瘙	lfr
畚	cgiue
泺	npio
棼	msor
杌	tjou
曛	wniur
捽	gboro
幪	ywee
巯	pxoi
妁	mkrr
堠	ljue
埒	lyei
鲆	dher
谮	sneu
褰	hjre
裰	hfu
葸	fgr
萜	fyiei
罟	cveii
瓴	qjeu
湲	nyee
榧	tvie
桴	tyuie
吖	kwiii
鳢	daei
骘	yhioo
馑	pyeiie
镏	vpiu
跂	zpu
谰	sfeiu
蓐	fyeir
茆	fpou
艽	fgo
砻	ldeo
湓	nsiui
椹	tguu
柝	tqrr
暌	wyeeo
峄	yfeei
岈	yaeui
劬	kkuo
饩	pvoe
饧	ptooo
鞯	qfeo
镉	vlei
锕	vyeiue
醅	thiue
酽	tsooo
鄣	mpui
轫	ysr
踣	zhiue
跣	zgoe
虿	wbiuei
蒹	fyro
芟	fdouu
芎	fxu
舁	tneo
粳	qbei
筌	ldeeie
禛	hhorrr
毽	wsur
怍	hzoei
孥	csui
妣	mmeu
埝	lqru
刖	hniii
鲳	dwiuee
饫	pfoe
赜	qxi
舻	plu
膦	hqour
罘	cheoi
磻	dmiue
痧	lnio
燊	pproor
氩	vseii
榇	theior
捩	gteo
埕	lkeei
圯	lgueu
鲉	daiu
鲂	dmreu
阏	fmorr
铖	vkuu
钚	vheoi
辏	yleeo
蟊	hbiuei
藨	fmrrr
蒴	fsoue
莨	fjuee
苾	floo
硚	dfoi
眚	gbiuee
狍	pkueuu
煸	ptiue
溏	naue
湔	naro
殂	bbiu
摽	gtee
埽	lcr
垴	lqre
嘏	vque
呣	kvu
骎	acr
铍	vzuo
铊	vvouu
酐	tneei
蛄	bveii
缑	xju
縠	bjuu
籴	dqro
笪	lqiuee
窅	dbiu
玠	sdoii
旻	wnre
拶	gwourr
悛	hcorou
怿	hfee
嵊	ycie
佤	jjeuu
黾	kwuuu
馕	pbiuei
郃	cyuiii
遘	psei
辋	ysro
蜊	bcii
蔌	fzouo
荛	fpeu
翛	jnu
缒	xjiue
绐	xciue
糨	qxiu
祧	hxre
瑱	shorrr
狨	pkeo
炅	wproo
洹	njiue
愦	hliuor
悫	baru
屙	zyeiu
媵	hluo
妫	mjuo
埙	lkiuor
叻	kwuooo
鸮	kwour
鲢	dyru
隰	ywuu
阼	yzoe
阋	ftou
逄	njrur
诔	sdeee
蛳	bneiu
菘	ftorr
缶	yoe
祓	hdurr
碁	gdeoi
砼	ddeie
睃	bcoro
甙	kdei
猁	pcii
狴	pmeie
犇	ccoe
炘	pqoo
浥	nkui
椤	tcou
柁	tvouuu
崤	yheo
崄	yqrr
娈	pmuo
圹	lare
嘌	kteei
勰	wwuoi
偬	jjrru
鸹	nfou
铌	vzouu
郫	dyuii
轺	ysi
裣	hqrr
茀	fxoi
苌	fboe
舨	paur
箨	lgur
窭	dqu
桄	thir
昃	wao
戡	gpeuo
廨	ahuoo
妗	mqorr
垱	lcuee
囷	kcoei
侉	jkee
黻	jqe
鹢	afiui
陔	yhre
鏊	kvor
酤	tveiiu
貊	djoi
蚺	bsei
薤	fbie
荽	fyuo
胙	hzoeie
纻	xvee
粝	qae
簋	lhiui
矇	bfeii
畋	gnoeo
甍	wqeuu
燋	pmrr
熳	pwiui
烝	cner
楦	tveiu
椟	tpur
揎	gvei
庥	ajeio
岍	yneeo
媸	myeiu
凇	wtor
僳	jtr
侔	jcoee
醑	tmi
邴	fduii
遄	yyru
衒	fbuur
蜩	bseie
葚	fguu
羼	zkr
纩	xar
秫	ctr
秕	cme
瘌	lzii
潆	nwuu
氘	vnoi
摅	gdru
佺	jdeei
亶	bxiue
鲊	dzoei
镪	vxiuee
鄯	kaiueu
踔	zli
赪	cliu
觳	bjou
褙	hziue
螽	nwiuei
蓥	wvo
肼	hyee
聱	kyeiie
耨	dyeir
绠	xbei
绖	xge
瞀	hniue
癜	lzei
痱	lzie
畤	gleir
猞	pqei
溽	nyeir
溆	nqeio
毖	mloo
栳	tfou
捭	gdoiu
悃	hkeio
彿	fxoii
堙	lteie
喈	kmoi
俜	jaeuu
鹩	kwiue
髑	mcou
骟	atur
铗	vwor
鋈	nfor
醌	tweuo
蚍	bmeu
薅	fmeo
萁	fgeii
芄	fgrr
胍	hyoour
绁	xduu
笕	lfiuo
瞋	bhorr
滹	ndoro
浬	ngiue
泚	ntie
戽	tweiii
愔	hmrer
嫠	dneou
卺	cnerr
麹	xnour
鹣	yfou
鲅	ddur
鞬	qsur
躞	zpr
躔	zaiu
躐	zwi
豨	hheoiu
诖	sheiee
蟥	bpiue
蓂	wwr
脘	hvee
缵	xgoe
籼	qyiu
硭	dfr
皲	qyuo
瘰	lguur
澌	ngoo
漭	nfeo
洎	njoi
殍	byuie
槠	tseie
彖	ahou
堃	mmei
囝	ksuie
嚭	akeoi
刬	knii
僦	jleo
鲮	dlo
阇	ffeieo
郇	kmui
谝	stiu
詟	lsree
襻	htoro
裒	btou
粜	ysroe
籥	lciuei
籀	lgou
笮	lzoe
熘	ppiuei
焐	pjiu
濞	njiuei
濉	nboi
枧	tfiuo
晡	wfeiu
崦	ykiuee
埗	lhio
坌	sleiee
飐	ahie
靺	qde
谠	scou
袢	hjro
蝥	hniuei
蝓	bqiuee
茑	ffour
茌	plei
脶	hkiuo
笾	lwru
瞢	wbiuee
燹	hhroo
殳	douu
挢	gfoii
扆	tjreo
慊	hyro
悰	hveei
埴	lheii
嗞	kauur
冇	dsiuu
鹾	lko
鹁	bsou
隹	moi
闿	fyue
钍	vleie
酎	tjei
跬	zhei
谳	spiur
蝰	bkei
蛞	bnoei
蚶	bdeii
舣	pnro
缧	xguu
畀	giue
璩	sdeou
牤	cxre
潴	npeie
梃	tsu
朐	hkiuee
旰	wneei
擿	ghiuo
忮	hpurrr
崁	ylou
尪	xsee
宄	vgou
埸	lwou
埏	ljie
儇	jceiu
髹	bjeio
饔	bpooi
镢	varo
钽	vqiu
酞	tkrrrr
郛	ysuii
赆	dkrrr
豳	yheou
衄	jcui
舳	paiuei
舡	pleie
肫	hbe
羰	kyeoo
罽	car
祼	hweio
矬	vfeiee
癃	lyou
畛	gdoo
畎	gpeo
焓	pqi
泖	npou
抃	gjeir
庹	dkueo
崟	yvor
峁	ypou
囟	zhee
哏	khue
鲔	ddiue
鲎	ndou
鲋	djeir
鞳	qfo
锶	vgr
邽	hyuii
邠	syuii
蒌	fquoe
莸	fpeou
罨	ckiuee
缊	xwiui
糸	duu
簏	lmre
笫	lxro
涴	nvour
浼	nwouu
浯	njiuee
浠	nheoiu
洇	nqiueo
泔	ndei
桤	tyue
曈	whiu
嵚	yvouo
哕	kyour
亹	btiu
亍	aee
丌	jeo
鲥	dweir
驵	abiue
馓	ppiuee
鞴	qpo
鞮	qsi
锍	vxoiu
逭	vhru
袷	hcore
蟮	bkro
舾	pteiu
耧	dquo
缌	xgru
绋	xxoi
筚	lmeii
窸	dmru
磙	dqur
璺	tseiue
澶	nbiui
溦	nyeou
洿	nkeeu
沢	nkueo
氪	vvouuu
栝	tnoe
枘	tliuor
旸	wtoo
幞	yjr
岜	yguie
咴	kdro
倮	jweio
鸲	kkou
霅	psree
锞	vwei
铯	vdui
轹	ypio
贳	dpiuo
豇	hleiee
蜣	bkou
蔟	fdoe
蓠	fqiuu
艿	fwuoo
肟	hyuuu
绨	xxr
祲	hcru
祎	hjeeu
瞭	bkroi
瘆	lcoo
疳	adei
疔	laeii
瓿	hkeu
璘	sqou
潾	nqour
泐	nyuoo
沚	nhie
欸	cvou
檑	tpiuei
樘	tce
楯	taeiiu
椠	yqeio
枵	tkeu
擐	gcei
垚	lleie
唣	kdeu
卬	pwui
亸	gsr
鳊	dtiue
鍪	hnor
醵	tdeou
郾	vwuoe
蹁	zti
觏	pseie
襕	hfeiue
袪	hweieu
菉	fcire
芾	fjiui
胂	hwii
耜	dhiueu
缳	xlou
篚	lvie
禋	hteie
硎	dneeo
砉	xdeo
眊	bwoeeu
瘳	lyor
疬	lauo
枨	tboe
曌	whrr
攮	gbiuei
惛	hmi
尥	xkrr
夐	dxiu
嗾	kdoe
唛	kxour
匦	vyou
刿	ybii
倕	jzoe
俶	jlio
黉	npiue
鲡	dceiu
锝	vwee
酺	tfeiu
酃	phiue
赙	dfeir
谖	syeeo
蜱	bdoiu
萆	fdoiue
莩	fyuie
荸	fbui
苈	fauo
艨	pweeo
翚	yqeu
罾	cwro
砜	daorr
皦	ddr
瘐	ltor
瓘	sfiu
珺	sciuee
猓	pwei
潲	nciro
洫	njiui
沩	njuo
桫	tnio
朊	hyou
憷	hmuie
惝	hciui
嶒	ywr
埤	ldoiu
厣	apiuee
倬	jliue
乂	hor
龢	chiu
龁	hvuu
鼯	tjiuee
黟	xbo
鹍	wmou
鸰	qfou
鲻	dwiuei
鲹	dcooo
骍	anre
鞲	qpi
鞨	qwou
镦	vgui
迕	vprur
辀	ypoo
蹐	znor
跱	zlei
跏	ztuo
趵	zkrr
诐	szuo
蛴	bnoi
蕞	fweii
菪	fveo
羝	kmrr
綮	tnuu
磡	dguu
硗	dpeu
盦	qtiu
皞	ddeo
瘼	lyeii
瘵	lyee
獍	pmo
狳	pqeio
犰	pgou
沄	nmee
檩	tbiui
榱	tgeo
栌	tlue
擗	gbue
掎	gkeiue
怃	hjeou
忭	hjeirr
忉	hsuo
庋	apurr
壸	bseii
咍	kciue
僇	jyor
仉	jaou
䜣	sqoo
龀	hnouu
鹆	fdiueo
魋	smoi
霪	pnor
镘	vwiuii
醣	taue
酾	tcei
鄠	pyuui
赑	ddiuor
谫	sauo
谇	sbor
襜	hhorre
蠓	bwee
蜞	bgei
虮	baouu
蒽	fqr
苁	ffor
芴	fjou
艟	phiuee
笊	lyoo
窊	dyoou
窆	djrurr
碲	dhiui
琇	scuooo
狃	paui
瀹	nqiuei
滉	nwir
浐	nheoo
榘	vkeue
掊	ghiuee
恓	hteiuo
庳	adoi
帱	yxei
屺	ygueu
夼	kwoi
垤	lgeu
噍	kmrrr
嗉	kxuu
呙	kliuo
吽	kcoee
俣	jkeeo
仳	jmeu
齁	jgou
鼗	xneie
鹮	clou
馘	ajeu
颃	baeo
顸	nneoiu
阘	fwur
镵	vweu
镟	vduie
镓	vveo
酴	tqe
蹅	ztiu
趼	zneeo
貘	dyeii
诼	shrrr
蚵	baiu
蚰	baiue
薷	fpeoi
蒗	yjue
苘	fsiuee
舯	pviu
缋	xliuor
绗	xfeei
箅	lgiuei
窬	dqiu
稃	cyuie
甓	bjeuu
焜	pweuo
炻	pdeoi
滏	nleei
涑	nzeiu
浍	ndeeu
氽	dniuo
氙	vyiui
楗	tsur
梼	txe
斝	hqrre
撙	gdei
摛	gqiuu
抔	gheoi
崚	ylor
嗌	kaori
喾	njoe
唵	kkiuee
哜	knoi
呒	kjeou
傒	jyuu
仫	jju
龆	hsi
鹇	ftour
鳣	dbiui
鳔	dtee
鲯	dgei
鞒	qfoi
镮	vlou
镧	vfeiu
镆	vyeiii
锸	vnoie
跶	zkru
趑	mpre
觫	hzeiue
蟛	baoo
缡	xqiu
糍	qauu
簦	lyeiu
矻	dvu
瘥	lkeie
瘕	lque
烜	pjiue
渰	nceo
檫	tvour
晢	mwiue
敉	qnoe
戥	wgeu
忺	haouo
弇	cneoii
尢	xeo
姱	mkeeu
厖	axoo
冱	wjuu
龠	qhiu
鲿	dcru
饹	pzour
飔	ahiue
颟	fforo
铪	vcor
钕	vmuo
跫	lariu
诹	syur
裛	bkui
蠼	bbiue
蜾	bweior
蛲	bpeu
虓	gdou
萑	fmoi
茇	fdurr
腠	hlee
糌	qnir
箦	lxiu
筅	lgoe
砟	dzoeie
眭	bheiee
甪	jtoue
漶	nkiuei
洳	nmiue
汆	dniuor
毐	lvuuo
椓	thrrr
枲	ckeio
昇	wjeoi
揸	gtiue
恧	ylr
嶝	yyei
嵛	yqiue
嵎	ywiuie
屄	zdr
婞	mlro
坜	lauoo
剀	ygii
佾	jfiu
魆	skeu
鄄	tlui
逴	lweir
逯	cnru
踦	zkeiu
赇	dweire
谂	sqru
裼	hwouoo
裈	hqeue
蛏	bfeiee
蒨	phee
菔	fhui
粢	pqr
硙	dyueu
瘅	lhroi
璠	smi
牾	cjiu
烀	pboro
炱	ckro
瀼	nbiuei
潏	nhiuo
渟	ngeiii
氚	vwoii
恝	xsru
孓	cjrr
嬲	gwuoe
圬	lyuu
嚚	hqiuei
劓	jgii
刭	pni
冏	sfiue
鹖	wkoruo
鸺	jtour
鳀	dsiue
鲬	dtur
鲦	dnei
骒	awei
隩	yzr
锔	vzui
铈	vbiui
钇	vpuu
鋆	lkreo
郤	fdiueu
蟪	bjiue
葜	fxuo
菝	fgeoo
舲	pqorru
缲	xkiuei
笱	lkiuee
禘	hhiui
碶	dxu
矧	vxii
眵	bbou
畬	qtiue
璁	szoure
牂	kkroee
渖	nviue
洧	ndiuee
氡	vnrr
榖	bcou
椀	tvouru
柈	tjro
柃	tqor
昉	wmre
揲	gdue
拃	gzoei
戋	keeu
廒	akee
墁	lwiuii
堋	lhou
伲	jzou
鲼	dpei
骺	maei
驲	awi
饸	pcore
陴	ydoiue
锼	vtii
锳	vfiueo
锩	vlu
铫	vxre
钐	vwoo
酂	ggiuo
郿	zbu
郐	dmui
跽	zgr
诇	ssiu
觱	klou
觋	lfiuou
蠛	bweo
蝤	bdr
虼	bvuu
蔸	fdoiue
茈	ftiei
艋	psiui
臑	hpeoiu
胗	hdoo
耑	yyeo
翾	clouo
缞	xgeo
绹	xkoe
縢	hluu
糈	qmiu
笸	lviue
礅	dguie
癀	lpiuei
痖	lseii
玦	svor
熛	ptee
煳	pvoue
滃	ncur
汔	nvuu
氿	ngou
毹	qhiio
殪	bbei
檎	tdreo
槚	ttiu
桕	ttoi
枒	taeui
揠	gviue
帨	ykou
巉	yweuo
嵝	yquo
崿	yhee
岽	yyio
岨	ybiuee
尨	xwrr
嫪	myor
塄	lcre
坰	lsiue
坫	ltiei
啫	kfeieo
唼	khuo
勍	lwuoo
劄	lciii
麑	mto
鹡	ndiuee
鸧	dgou
鲰	dyurr
鲐	dciuee
髟	bei
靸	qso
钖	vto
钌	vcui
醾	tyr
轵	ykorr
躜	zgoei
跞	zpio
谞	smiu
訚	fsr
衎	fneeii
螗	baue
蛸	bciuee
蒻	fxre
芑	fgue
舴	pzoei
脬	hyuie
耪	dhreu
簃	lcour
筦	lveeou
硪	dwoei
硁	dpure
皛	ddoiu
瑨	ssiue
爇	flor
熇	pgiuee
渫	ndue
淠	ngiuei
浡	npru
氾	nguuu
氍	bboire
欻	ppo
楙	theior
棐	zte
杻	taui
搿	ncoe
挦	gceir
惙	hfur
悝	hgiu
廋	atiu
巇	ydeiu
嵫	yauur
崒	yboro
峣	ypeu
岢	ygeiue
嬅	mfeei
媞	msiuee
夬	vdor
埘	lweirr
埆	lhouo
垧	lziu
哢	kseo
僬	jmrr
俵	jxouo
黹	jqro
鳇	ddeei
鬘	bwiui
髎	myoro
馌	pwiuii
飑	ahouu
颎	npeoiu
阌	fyur
镡	vtiue
镙	vguu
铼	vwio
钬	vproo
醭	tjroe
醨	tqiuu
鄜	myuii
迮	zrr
螬	bjiuei
蜎	bkiuee
蔀	fhiue
蒉	fliuo
萩	fcro
荭	fxei
荄	fhreuo
臁	har
脒	hqro
胨	hyio
肜	hwoo
翃	dcu
绲	xwe
糵	fjiueu
簕	lquoo
穸	dbour
穟	cweo
稂	cju
瞍	btiur
癍	lsreo
畯	gcor
甏	aweu
珧	sxr
濩	nfoir
溱	nloe
淏	nweeor
洸	nhir
洑	njeor
沨	naorr
橦	thiuee
槔	tdeor
棨	tneio
棓	thiuee
杙	tkeur
昺	wfor
搒	ghre
掞	gpro
捃	gciue
憝	gsoeo
庀	anou
岣	ykiuee
屼	yjou
垲	lyue
黪	xcoo
鹋	fgou
鸸	yfour
鳓	dquoo
鳑	dhreuo
鲣	dmei
鲗	ddii
鲏	dzuo
髽	bfeiee
飗	ahour
靿	qpu
雱	pmre
阽	ytie
镋	vcouu
锽	vdeei
锇	vwoe
铏	vnee
跐	ztie
赟	njeur
謦	lzouur
襚	hweo
蛑	bcoe
藟	fgiue
蔹	fqrr
蒐	fsoi
莰	flouo
莛	fsur
荬	ftrr
芈	jjie
芃	farr
艚	pjiuei
腯	haeii
腧	hqiuee
脞	hfeiee
肭	hliuor
翀	yviu
缍	xzo
缂	xqe
粿	qwei
簠	lfiui
篥	lteio
秬	cvu
碥	dtiuei
睎	bheo
眢	bgiu
瑳	skeie
瑑	saouo
狁	pcou
烺	pjuee
澥	nhuo
潟	ntour
滪	nheoiu
滆	nlei
溞	nfri
浈	nliuo
泶	nniuo
枹	tkue
暵	wdi
弢	xyurr
尜	ckio
嫜	mmeii
奓	kbour
墐	lyeiie
剟	ffii
剞	kgiii
佧	jlirr
伈	jlrur
龂	hqui
鼷	tyuu
鹴	pvour
鹨	ydoooo
鹔	snor
鞡	qgre
鞔	qwouu
闶	fbou
镴	vwiueu
镈	vfeir
锾	vyee
锛	vkeieo
铷	vmi
辌	ylre
踶	zsiu
赗	dwiuee
赒	dseiei
谿	ypeor
褕	hqiuee
袆	hjeeui
蠋	bcoui
螣	hliue
蝻	bpiur
蕰	ywiuii
蒱	fgeiu
蒎	yaouo
茚	fpeui
舠	psuo
肸	hfeii
聍	yvei
耵	yaeii
糇	qjue
粞	qtei
礌	dpiue
碹	dvei
硇	dzore
砩	dxoii
瘃	lhrr
疢	lpro
瓞	yjeeor
璆	syoro
瑢	sdor
琯	sviu
琭	scir
琤	sbouu
獯	pniu
猰	pxuo
狝	paoui
爝	pyiuii
爚	pciuei
烔	pseiu
橑	tkro
椐	tzei
朳	tforr
憺	hhorre
惔	hpro
怊	hsiu
忳	hbeu
彳	foo
廑	ayeii
岵	yveii
孅	mfeu
嫽	mkro
墼	ysouu
圊	kheei
嗍	ksou
叆	myeou
儳	jweu
偲	jgr
乇	jneuu
黡	apiur
鳂	dgeuor
鲞	ldoui
鲕	dyeoi
鬏	bcroo
骱	mdoii
颥	pyeo
韨	jdur
雊	kkoi
隃	yqiuee
镠	vyor
锓	vcru
铟	vqiue
铘	vaui
铒	vyeiie
酏	tdui
辁	ydeei
蹯	zmi
讻	shui
觿	hyoir
觖	hvorr
袼	hzouri
螋	btiurr
蕺	fkeiie
蓢	fjueeu
莶	fqrro
茺	fxou
茝	fqeii
苤	fheee
芤	fsuu
芏	fleiee
艎	pdeei
腘	hkeeie
胲	hhreu
胬	clor
胠	hweieu
肷	haouor
耰	ddiuee
耇	fkiuee
羕	kjuuo
绱	xciui
纴	xsoei
糒	qpoo
簰	lkoi
簉	ljru
篼	ldouo
筥	lkiuee
稆	ckiuee
祃	hauue
碡	dxuu
矰	vwr
瘛	lxu
疐	bgui
甦	bgoe
玃	pbiuee
瀵	nqiuei
澴	nceiu
滠	nyur
湉	nhoe
涘	ncoee
殣	byeiie
椑	tdoi
棬	tluu
杩	tauue
昽	wleou
敫	dmoe
慆	hyoie
彟	cjei
崾	ytuo
岠	yvue
嫘	mguu
墦	lmi
埼	lkeiu
埵	lzoei
坬	lyoou
噀	kgue
嘚	kfiue
唪	kleei
叇	mcir
卣	lkuee
劂	asou
冁	hzeii
伋	jsour
仂	jwuo
鹯	bxiuee
鹙	cpo
鳙	daue
鲴	dkeiiu
鲌	ddoiue
馉	pmiuu
馃	pweio
饳	pyui
陧	yweie
陞	yjeoi
铚	vge
钭	vweii
鄹	yfoio
郈	alu
邶	zyui
遹	hsoriu
辒	ywiuii
蹜	zvor
趯	myoi
赕	dpro
裉	hhuee
衠	fhore
蟫	btiue
蛘	bkroe
蔊	fpiu
蓰	ffie
葎	ffu
茼	fseiu
茳	yleiee
舭	pmeu
臜	hgoe
缏	xjeiu
绤	xfor
簖	lquooe
筻	lbeiu
窀	dbeuiu
璈	skeei
珌	sloo
燏	phiuor
焞	pgui
澛	ndiuee
澉	nteii
滫	njoeo
淜	nhou
涠	nkeeui
洺	nbiuee
沲	nvui
棁	tkou
柷	tkouu
朏	hyuiii
晫	wliu
昒	wjou
旐	dxre
斠	pseier
敔	jkoe
攉	gpoi
捯	ggii
慭	wneor
惎	glru
悢	hjue
廾	neoi
帡	yaeo
嬿	mdiu
塅	lgoi
垞	lvoeu
坶	lvuur
喤	kdeei
哳	kmeie
吣	klrurr
僰	qqor
偭	jheo
偓	jzeu
佽	jpre
鼽	jgouu
鼢	tsoru
鹎	dfouru
鳠	dfoir
鳘	vvoeor
鲩	dveeo
鲚	dnoii
鲒	dneie
鲃	dguieu
鬒	bhorrr
鞁	qz
镃	vauu
锧	vaeio
锊	vyeir
铞	vkiui
钪	vbou
钆	vpuuu
銎	laro
鄫	wyu
邲	ljui
迺	trru
蹢	zhiuei
踺	zsur
讱	ssrrr
蝘	bviue
虒	adou
薢	nhuoo
蕻	fbei
蒟	fhoui
菂	fdour
芼	fwoee
膣	hdeu
腽	hwiui
脿	hxouo
耔	dsui
翙	ybu
羖	kdouu
罱	cpi
繄	vvouur
窎	dfouru
稌	cqe
禔	hwiue
祕	hlo
祏	hdeo
磉	dfur
砹	dfor
砘	dbeuiu
砗	dyeu
眍	bmeo
皭	dyiuii
痦	ljiuee
疍	mqiue
璪	skiuei
琲	szie
琫	slee
玡	saeu
玚	stoo
玘	sgue
犨	mmo
牿	cjo
煴	pwiuii
焗	pzu
瀍	naiue
滗	nloee
湑	nmiuee
浉	nneiu
洚	nneu
汋	nkrrr
槱	ttr
榍	tziro
棫	tkiuee
梿	tyru
柊	tnrr
晙	wcor
昈	wtr
搛	gyr
掭	gfir
扊	tproo
忞	nlrur
庼	aneo
岞	yzoei
屃	zdiu
孖	ssui
嫕	mvoee
嫄	maoi
媭	wnu
婘	mlu
娵	myur
娀	mkeo
姤	maeiu
姞	mnei
奭	kjoiu
奡	dbeo
堨	lwouo
堍	lwour
咇	kloo
勚	dpiuor
劢	wwuoo
冮	wleie
傢	jveo
偰	jxu
倞	jlre
倓	jproo
麀	mnou
鹛	zbo
鹒	acoro
鹀	lfou
鸻	faour
鸤	zfou
鳒	dyro
鳈	ddiuor
鲾	dli
鲖	dseiue
鬷	lhui
髢	bduiu
骕	asoi
骉	aau
骃	aqi
靰	qjouu
镲	vvour
镱	vmru
镩	vvorr
镨	vaii
镚	vyoue
镅	vziu
锬	vproor
锪	vjru
锎	vfeeo
铑	vfouu
钫	vmre
钔	vfri
鐾	bvor
酦	txuou
鄗	gkuii
踒	zcu
觭	hkeiue
袗	hdooo
蟏	bfu
蝲	bzi
蘘	fbiuei
藠	fdoiue
薿	fnoeeo
蕹	fbuuo
蕗	fzour
蒇	fkiuor
萹	ftiue
萚	fgur
菼	fproor
菥	ftoo
苠	fque
苊	fauu
艴	xnouu
腙	hveeio
腒	hzeiiu
耩	dpiuei
耥	dciui
耏	ywoo
羑	ktou
纼	xxii
箢	lvour
筤	ljuee
筢	lguieu
筀	lheie
竫	hbouu
稙	chei
稑	clore
祊	hmreu
礤	dfourr
礓	djiuei
磹	dtiuee
碨	dgeuor
碃	dheeie
砮	cdeo
矼	dleiee
盉	cciui
瘊	ljueo
疰	lkree
甡	ggoee
甗	dleuu
瑀	sjiu
珽	sjeie
玼	stiei
獴	pweeou
猺	pyoe
猇	pdouu
猃	pqrr
狉	pheee
牁	kgeiu
爟	pfiuei
焌	pcoro
澼	nbue
漼	nyoire
漻	nyoro
漦	dneoi
溻	nwur
湴	naii
浞	nkie
泜	nmrr
泙	nher
汧	nneeo
氇	wdiu
氆	wai
檵	tpuur
橥	pfeio
榰	tfoui
榑	tfeir
楩	tjeiu
棽	mqorru
梠	tkiuee
桹	tjuee
桯	tkeeie
桊	lteior
杕	tkeor
朓	hxreo
昳	wjee
昫	wkiue
摴	gpee
搌	gzei
揞	ghiuee
扅	tbou
戤	wfiu
憭	hkroi
悆	qtru
弸	xhoue
弆	wneoi
嶲	ymiui
嶓	ymiue
嵁	yguu
崞	yguiee
崀	yjuee
峘	yjiu
宬	vkuuu
婼	mfeo
婌	mlio
妧	mlee
堲	tweie
堉	lxiue
埯	lkiuee
埇	ltur
圌	kyeoi
囧	kfiuu
嚄	kfoi
噂	kdeir
啴	khro
哿	tgeiu
哱	kpru
匼	vcore
匜	vduiu
勔	hwuooo
劼	nwuoo
儦	jmrrr
傺	jyee
傉	jyei
偁	jyiui
侘	jvoeu
侂	jaoe
侁	jgoe
佴	jyeii
齇	jgie
齄	jgei
鼫	tdeoiu
黇	paor
鹠	pgour
鹟	cyour
鳛	dyoi
鳋	dfri
鳁	dwiuii
鲪	dciuee
鱽	dsuo
骦	apei
骣	azu
骙	ayee
馇	ptiuee
颋	sre
靽	qjro
靬	qnee
隺	qmoi
阢	yjouu
镥	vdiuee
镤	vjro
镄	vxoii
锿	vgouo
锫	vhiue
锘	vfeoi
铻	vjiue
铴	vnu
铕	vdiuee
钶	vaiuee
钘	vneeo
钋	vlir
鄅	jkiuie
郪	jsuo
轪	ykeo
谼	fdiuee
觟	hheie
襫	hkeo
褟	hwur
袯	hxuou
衃	gjiui
螵	btee
螱	zseir
螠	baor
蛃	bfor
蚄	bmre
虸	bsuie
藦	fyoee
薳	fnoio
薁	fzro
蔈	fteei
蓏	fyoo
蓇	fmiuu
葰	pcorou
葙	fveio
葖	fdeor
莙	fciue
荖	ffouu
荓	faeo
芣	fheoi
艅	pqeior
胩	hlirrr
耱	dyeoiu
耤	dpiuee
翂	ysoru
筘	lgiuee
笯	lmu
穜	chiue
穄	cye
礵	dpeio
礞	dwee
磲	dneuu
磜	dyee
磏	dyroe
碏	dpiuee
硿	ddeiee
硍	dhue
硊	dhuu
砫	dkre
砆	djee
睄	bciuee
瘭	ltee
瓻	hdiuie
瓖	sbiu
璲	sweo
琄	skiuee
珷	sjeur
珫	sxou
珝	syure
玱	sduu
玭	smeu
玞	sjeeo
玙	sqeue
犋	cbor
牚	caeu
煺	phru
煟	pgiuee
烻	pjie
炟	pqiu
澂	nyeoe
淴	njrurr
淟	naorrr
浰	ncii
浕	nkrrrr
洴	naeo
沺	ngiuei
汭	nliuor
欂	tyeiu
榀	tkiuei
楱	tleeo
椸	tduiu
梽	tlrur
梴	tjie
桲	tpru
栻	tkeiee
栟	taeo
晐	whreu
旴	wae
敩	nsoeo
攽	snoeor
摏	gloi
搋	gaieu
揾	gwiui
拤	glirr
扺	gmou
憙	akru
幖	ytee
嵲	yjeio
峿	yjiue
峧	yqorrr
峗	yhuu
峃	nyiui
岊	gyi
嬬	mpeo
嬥	myoir
嫭	mdor
媱	myoe
媆	myeor
媄	mkeor
婳	mjiu
姽	mhuu
墚	lnu
墈	lguuo
塥	lleiu
塝	lhreuo
垕	alei
垍	ljoi
嘡	kceie
咺	kjiuee
咥	kgeur
咡	kyeiie
叚	que
劁	mni
剕	zniii
凵	suii
凓	wteior
冔	wkee
儴	jbiu
僎	jgue
倴	jkeieo
倧	jveei
俬	jcur
俙	jheoi
俍	jjue
佖	jlo
伾	jheee
伭	jbuu
丏	ktuu
齉	jgeiu
鼩	tkiuee
鼒	tbu
麖	mlre
鹱	ffoir
鹝	lfour
鸼	pfour
鳡	dkeiue
鳆	dviu
鲺	dpo
鲝	kdouiu
鱾	dgueu
髃	mwiuie
頔	adiue
韂	qhor
鞧	qdr
霨	pze
陑	yyeoi
陎	yjeei
镎	vcoe
锖	vheei
铽	vkru
铹	vwuooo
铥	vjeie
钸	vdiui
钷	vviu
釐	dneoiu
酅	ymiuo
鄘	asiu
鄑	swu
鄌	asiue
鄃	qhiiu
鄀	fdiueu
郚	jkui
邘	ayuiii
遆	hyru
辿	yrru
轷	yboroe
軎	ykiuee
蹾	zgu
蹽	zkro
貆	djiuee
豮	hpeii
誌	slrur
訄	gsre
觍	afiuo
觃	fsuie
褯	haeiie
袴	hkeeuu
蠧	bdiue
蟓	bwoui
蜐	bwu
蚆	bguie
虤	daie
虍	die
薸	yteei
蔃	fxiue
蒈	fmoiu
萳	fpiur
菍	fqru
莝	ffeiee
荮	fxeir
荙	fkrurr
荁	fjiuee
茽	pviue
茓	fdrr
膪	hhiuii
膙	hxiu
腨	hyeoi
脟	hyeirr
脎	hheio
胈	hdurrr
耢	dwuoo
耠	dcor
耖	dvior
翷	qbeui
翈	ayureu
羱	kaoi
羓	kguieu
罶	cpiu
缐	xdiuor
簝	lkroi
篯	lveeu
箖	lmeio
筼	lkiuor
筶	ljoei
筜	lcueee
竘	hkiuee
竑	hdurrr
禤	hcur
禚	hkrrr
祾	hlor
祋	hdou
砵	dteee
砢	dgeiu
砠	dbiue
砄	dvor
瞫	btiuee
盷	bkre
皕	jdeo
癗	lpiuei
痓	lgeur
痄	lzoeie
痃	lbuu
疭	lforor
疁	gyor
畖	gyoo
瓀	speoi
璬	sdre
璥	sfou
璒	syeiu
瑬	nxoiue
瑝	sdeeie
瑖	sgoi
瑔	sdiuo
瑆	swoe
瑅	ssiuee
瑃	sliue
瑂	sziu
琡	slio
琟	smoir
琔	sprr
琎	syrur
琍	scii
琀	sqiuee
珹	skuu
珸	sjiue
珵	skeeie
珦	sziue
珖	shir
珕	swuo
珒	ssue
珇	sbiue
玿	ssiuee
玹	sbu
玶	shero
玓	skrr
玒	sleiee
猹	ptiuee
猸	pziue
猯	pyeoi
猄	plre
犏	cti
牮	bcoee
牥	cmre
爔	pkeio
燚	pproor
熻	pcur
熥	ptru
熜	pzoure
煃	pkeie
煁	pguu
烶	psurr
炣	pgeiu
炌	pdoii
灈	nbiuee
瀱	nceor
瀔	nbeo
澭	nbuuo
潽	naiir
潵	npiuee
潖	nseei
漹	nkuer
漷	ngui
漴	nyrr
漈	nyeei
滍	nyeiu
溵	nauee
溠	nkeie
溚	nfore
溍	nsiue
溇	nquo
湣	nqiuee
湝	nmoi
渼	nkeor
淯	nxiue
涢	nkiuor
涐	nwoe
涍	nfui
浲	nneeei
浭	nbei
浟	njoeor
浛	nqiuee
洭	nveeie
洨	nqorrr
洢	njue
洈	nhuu
泃	nkiuee
泂	nsiuee
沘	nmeu
沇	ncou
汫	nyeeo
汈	nteee
氕	vjoo
毑	vduiuu
毌	vuue
歔	djou
歅	tlou
櫆	tsrr
榅	twiu
榃	mgiue
楪	tdue
椪	taii
梾	twio
梣	tyorr
梌	tqei
栴	tviu
栐	tjuu
柖	tsiuee
枍	tfeuu
枅	tneeo
杧	txre
暲	wmei
暕	wzr
暅	whei
晱	wproor
晊	wgeur
晅	wjiue
昪	wceo
昤	wqor
昡	wbuu
昄	wau
旿	wvei
旵	wyiu
斶	qcoui
攴	lfu
撖	gtei
揳	gxuo
挓	gvoe
扽	gbe
扂	ttie
戭	vjiuei
憕	hyeiu
慬	hyeii
慥	hjrur
慓	hteei
愭	hfou
悈	hkeoi
弶	xlrei
弪	xpure
廙	agei
廆	asoiu
庤	aleir
嶦	yhorr
嶟	ydeir
嶍	yyoi
嶅	kyiui
嵖	ytiu
嵅	ykeiu
崡	ycr
崌	yzei
峱	paiui
峂	ynr
屾	yyiui
宧	vqei
媖	mfi
媓	mdee
媂	mhiui
婻	mpiu
婫	mweu
婤	mseie
婍	mkei
娭	mcoe
姶	mcor
姈	mqorru
妭	mdur
妘	mmee
墣	ljro
墘	lxeo
堽	lcei
堼	hjeie
堧	lyeo
堎	lloro
堌	lkeiiu
埪	ldeiee
埌	ljueeu
垵	lvuo
垯	lkru
垙	lhir
垎	lzouri
坽	lqor
坒	mlei
坋	lsor
圲	lnoe
圢	laeiii
圙	kfeoi
圐	kcre
嚆	kfr
噇	khiuee
嘢	kgur
唝	kliuor
哃	kseiu
呇	nkiuee
厾	pweie
勠	ydooou
剋	vxiii
剅	hniiii
凘	wgoo
僔	jdeir
偡	jguu
倻	jyuiii
俫	jwio
侹	jsurr
佸	jnoei
佁	jciuee
伣	jfiuo
乸	dvuu
𬺓	hmuieo
𬺈	hkeiue
𬹼	hdoii
𬸪	mgou
𬸦	dmou
𬸣	hfour
𬸚	pseor
𬸘	vwuoeo
𬷕	ffouru
𬶮	daiue
𬶭	dyeei
𬶨	tnou
𬶠	dzr
𬶟	dzii
𬶐	dxreo
𬶏	dhuuu
𬶍	dvouu
𬶋	dkiuee
𬴊	aqo
𬴃	axe
𬴂	azie
𬳿	aqe
𬳽	agoe
𬳶	asiuee
𬳵	ahee
𬱟	hgeo
𬱖	aneoi
𬯎	yliuor
𬯀	ynoi
𬮿	yyue
𬮱	fteie
𬭼	vweo
𬭸	vqour
𬭶	vxiur
𬭳	vaiuee
𬭯	vqoe
𬭬	vxee
𬭩	vcur
𬭤	vjue
𬭛	vnuo
𬭚	vguie
𬭎	vveou
𬭊	vtei
𬭁	vvuu
𬬿	vsiu
𬬻	vlue
𬬹	vwii
𬬸	vtr
𬬱	vqooe
𬬮	vboe
𬬭	vdou
𬬩	vkeur
𬪩	tlruo
𬩽	cjui
𬨎	ydro
𬨂	ymou
𬤝	sjiuee
𬤊	ssiuee
𬤇	ste
𬣳	shue
𬣡	skeeu
𬣞	sveee
𬣙	saee
𬟽	byio
𬟁	flour
𬞟	fhio
𬜯	fforor
𬜬	ffiue
𬙋	xbiue
𬙊	xxe
𬙂	xveiu
𬘯	xgui
𬘭	xmei
𬘬	xhee
𬘫	xveeo
𬘩	xjeie
𬘡	xqiue
𬘘	xqou
𬘓	xwo
𬕂	lliuor
𬒗	dliu
𬒔	dhiuee
𬒈	ndeo
𬍤	sce
𬍡	ntooee
𬍛	spio
𬌗	acore
𬊤	phro
𬊈	pce
𬉼	pmeo
𬇹	nkeei
𬇙	ndiuo
𬇕	nweu
𬃊	taeiiu
𬂩	twor
𬀪	wfiuo
𬀩	wjeeu
𫸩	xmeo
𫷷	avou
𫶇	yfr
𫵷	yaeuo
𫰛	mpur
𫮃	lhroiu
𫭼	lwuooo
𫭢	ldouu
𫭟	lmeo
𫫇	ksru
𫢸	jhro
𫠜	htouu
𫠊	abu
𫠆	pfeo
𫟼	vkrur
𫟹	vpeii
𫟦	yweo
𫟅	xlreiu
𫞩	sfeiuo
𫛭	psou
𫚭	dwiueu
𫚖	tdou
𫚕	dneiu
𫘬	ayuu
𫘪	aao
𫘨	asiuee
𫘧	acir
𫘦	akoe
𫘝	avor
𫘜	anreo
𫗴	pbiui
𫗧	pzei
𫖳	ckeoi
𫖯	xneoi
𫖮	ygeo
𫔶	fjeio
𫔎	vhiuo
𫔍	vmiu
𫓹	vgei
𫓶	vkiuee
𫓯	vheie
𫓧	vjeeo
𫑡	kwuui
𫐓	yhei
𫐐	ytou
𫐄	yjouuu
𫍽	scei
𫍲	stiur
𫍯	skeiue
𫍣	sseiu
𫌀	hxiuo
𫇭	fjuo
𫄸	xniu
𫄷	xmru
𫄨	xheo
𪾢	bfiuo
𪩘	ypiu
𪨶	ykeue
𪨰	yaiuei
𪤗	lyoro
𪣻	lquoe
𪟝	xduo
𩾌	dauee
𩾃	dwouu
𩽾	dvuo
𨺙	ytouu
𨱔	vdei
𨱑	vpiue
𨱏	vfor
𨱇	vweir
𨭉	njeie
𨟠	bboire
𨚕	cnui
𨙸	pfui
𨐈	yhir
𧿹	zvuu
𦰡	fsuii
𦭜	fkor
𦝼	hquo
𦙶	hveiiu
𦒍	hgur
𦈡	xpeo
𥻗	qtiuee
𥖨	dkiuei
𥕢	djiuei
𥔲	dheeu
𤫉	spre
𤩽	spiuro
𤧛	shiui
𣸣	npeiii
𣲘	njeou
𣲗	njeeu
𣗋	tcouu
𡐓	lauee
𡎚	ltiuei
𠳐	kxui
𠙶	csuii
𠅤	bgr
鿏	vxour
鿎	dkru
鿍	lneui
鼱	thee
鹲	wjeou
鹐	dtour
鳤	dlrr
鲘	daeiu
鬶	jfei
馧	cwiu
馞	cweir
馝	cwru
饻	pjre
鄚	yyuii
邿	ljuii
逎	trrur
蚲	bher
虷	bneei
蒄	wleir
葴	fkeiu
萣	fprr
莿	fqii
茋	fmrrrr
苧	fveii
苉	fvouu
舥	pguie
胣	hvui
翯	ygiue
粬	qai
穙	cjro
禒	haouoo
碈	dmiuee
硔	dpeii
癿	dpuu
璱	ssee
璮	sbiui
瑧	sloe
瑓	szrr
琈	syuie
珢	shuee
珛	sdiue
珋	spo
玤	sxe
牻	cxoo
煓	pyeoiu
煋	pwoee
焆	pkiuee
烠	pdiuee
瀌	nmrrr
濋	nmui
澽	ndeou
澪	npor
潩	ngeiie
漤	nmuo
漖	nfuie
漋	nyou
滧	nqoro
溹	nbuur
溁	nweio
涄	naeu
洣	nqro
洘	nfeu
洓	nqeiu
泇	ntuo
毪	wcoe
檞	thuo
橞	tjiuee
槜	tmu
楒	tgr
椆	tseiei
棪	tproor
棤	tpiuee
栒	tkiuee
杄	tnoei
朸	twuo
暿	waiu
暶	wduie
晪	waor
昣	wdo
旞	dweou
揕	gguuu
戣	yfeu
愐	hheoiu
愃	hveiu
恔	hqorrr
徛	fkeiue
彐	cuee
弨	xsiuee
庱	alo
崶	yheir
峛	ybiii
峏	yyeoiu
寁	vjuee
墡	lkroei
墕	lkuer
塱	jtouee
堾	lliue
堐	laeie
埫	lciui
垿	lauru
垾	lwee
垺	lyui
垏	lsue
垈	bleie
坥	lbiuee
坉	lbeu
圫	ljeuu
咉	kseor
叕	ffur
劐	fmu
傃	jxuu
侴	qaii
䶮	lfee
䴙	bfou
䴘	adouo
䴗	wpour
䴖	hfouru
䴕	bnou
䴔	qhou
䴓	jyou
䲢	hlou
䲠	dliue
䲟	dpeui
䦃	vfeieo
䥽	vxuo
䣘	clu
䢼	pyuuii
䢺	ysuiii
䝙	dmeo
䗴	bloei
䗪	dfrr
䗛	bjour
䗖	bfr
䕫	fdie
䓬	fliue
䓫	fkeiue
䓨	wyoe
䓛	fzui
䓖	fduo
䐃	hkeior
䏲	hxrou
䏡	hsee
䏝	hyurr
䎖	wyur
䎃	slu
䌹	xsiuee
䅟	ccoo
䃎	dkour
䃅	dhro
䂮	xseo
䁖	bquo
㿠	dhir
㽏	nceii
㻬	speeu
㺄	pqiue
㸌	ppoi
㸆	pjiee
㶲	ptoue
㵐	naroe
㴔	nxru
㳚	nkrrrr
㳘	nxouu
㳇	nlor
㰀	tcouo
㮾	jtouee
㭕	tweieu
㭎	tsorr
㬚	wxi
㬎	wpru
㬊	wyeeou
㫰	wjue
㧟	gneu
㧑	gjour
㧐	gfuru
㥄	hloro
㤘	hxouu
㠓	yweeo
㠇	yleou
㟃	ytei
㛹	mjei
㛚	mtu
㛃	xsuo
㙦	qtrre
㙘	ltuoe
㙍	lfur
㘎	kfue
㕮	klor
㑊	jpreo
㑇	jxouu
𫄧	xjie
仈	jforr
伻	jher
凃	wqei
媢	mwiuee
鴘	cnoi
暋	qniuee
蚡	bsor
穀	bjoe
𮧵	jyeiii
鿔	vgeiu
鿭	vaou
𫟷	vhrer
鿬	dgiue
鿫	vzr
囍	akei
牠	cdu
祂	hdui
奀	hkeor
咁	kdeii
呯	kher
喰	kpor
艹	feii
鶸	xwu
